------------------------------------------------------------
------------------------------------------------------------
------------------------------------------------------------
------------------------------------------------------------
o?--X---Xo---M-----------X--------X-o----------oXX----------
----B----------o-o---|-------M----?M--X--X----?-------------
-------X-------X-?----B-XB-------------B---M?---E--?--------
-------------B------E--X------------------M-BM-X---------v--
----M---XM--?------o-X-----Mo--?--?o---B-MX---M----------f--
---X---M-X--Xo------X-------B-------?M?--o-E--BE-X-------f--
--?-----?-----?-------X-M-o-|-M----?--------M--oM--------f--
B---------|-?-X-?---|M----------EBX--?--M----------------f--
X------------|--|-B-X--X-----M-MM-E-M--------|-XB--------f--
------------------------------------------------------------
m-------------------------------------------------------XXXX
XXXXXXXXXXXXXXXXXXXXXXXXXXXXXXXXXXXXXXXXXXXXXXXXXXXXXXXXXXXX
