--------------------------------------------------------------------------------
--------------------------------------------------------------------------------
--------------------------------------------------------------------------------
--------------------------------------------------------------------------------
--------------------------------------------------------------------------------
--------------------------------------------------------------------------------
---------B-?---B------B--B----B-----?----------------------B--B-----------------
------------------------------------M-------------------------M----------?-----v
-----?---B-------------??--------------BB?------?-----?--------B-B---------B----
--------------?---B----?-B------B-------B?--------------------------------------
------------?-----------?-------B-----B----------------------?----?------?------
-----------B?------------------------?B-----?---------B--------B---B-----B------
----?-----------?----T--------------------B------------?----?---?B---B-T--------
---------------------|-------------------------------------------------|--------
m--------------------|--------------------T----------------------------|--------
XXXXXXXXXXXXXXXXXXXXX|XXXXXXXXXXXXXXXXXXXX|XXXXXXXXXXXXXXXXXXXXXXXXX--X|XXXXXXXX
