------------------------------------------------------------
------------------------------------------------------------
------------------------------------------------------------
------------------------------------------------------------
------------------------------------------------------------
------------------------------------------------------------
------------------------------------------------------------
-------MooooooooEoEooooooBooooBooooooooBoooooooEoo------v---
-------------o--o-----------------------o----o----------f---
-------ooooooooooooooooooooooooooooooooooooooooooo------f---
--------------------------------------------------------f---
-------B---B-------B--B---E--------------B-B------------f---
-------ooBooBoooooooooooBooooooooooooBBoooBooooooo------f---
--------------------------------------------------------f---
m---------T---------------------------------------------X---
XXXXXXXXXX|XXXXXXXXXXXXXXXXXXXXXXXXXXXX--XXXXXX--XXXXXXXXXXX
