------------------------------------------------------------
------------------------------------------------------------
------------------------------------------------------------
------------------------------------------------------------
------------------------------------------------------------
------------------------------------------------------------
------------------------------------------------------------
---------o-------?----------------------------------------v-
-------------------B---------------------------o------------
-----------------------------------B--------------EE--------
-----------o-----------------------?------------------------
--------?------------M-----o--------------?-------o---------
-----------?-M---?----?--------------B---M?-------BMT-------
--------T-------------------------------------------|-------
m-------|----------T--------------T---T------T------|-------
XXXXXXXXXXXXXXXXXXX|XXXXXXXX--XXXX|XXX|XXXXXX|XXXXXX|XXXXXXX
