------------------------------------------------------------
------------------------------------------------------------
------------------------------------------------------------
------------------------------------------------------------
-E------X-XB------E------B-----B-X---B--E-BM---BX-----------
----------XX-------B-E--------??-------X----E---------------
-------X-------X---?--Mo--|B---o--B-------B---|---?---------
--X-----?----o----?---X|--B---X------X--E--------X-------v--
--o---?-X--------B-----E?-M-E-----------------B----------f--
M---X----------?MM-?----------?-|X------X-BE-------?-----f--
--X--?------X----M--------M?----B--B---M-----------------f--
BX-------------BX---X---B--------B|o---?-o--?------------f--
--X------X------B--BBB-X----?----?----------------o------f--
---------------------------------------------------------f--
m-------------------------------------------------------XXXX
XXXXXXXXXXXXXXXXXXXXXXXXXXXXXXXXXXXXXXXXXXXXXXXXXXXXXXXXXXXX
