------------------------------------------------------------
------------------------------------------------------------
------------------------------------------------------------
------------------------------------------------------------
------------------------------------------------------------
------------------------------------------------------------
------------------------------------------------------------
-------B--------E-E------?----?--------o-------E--------v---
-----------------------o-------E------------------------f---
-------------o-----------------E------M---------??EMB---f---
--------?------------?----------------------------------f---
---------??-?-----------o-----?-----------------?-------f---
-------ooooooooooooooooooooooooooooMoMoooooooooMooB-----f---
--------------------------------------------------T-----f---
m------------------------------------------------T|-----X---
XXXXXXXXXXXXXXXXXXXXXXXXXXXXXXXXXXX--XXXXXXXXXXXX||XXXXXXXXX
