------------------------------------------------------------
------------------------------------------------------------
------------------------------------------------------------
------------------------------------------------------------
------------------------------------------------------------
------------------------------------------------------------
------------------------------------------------------------
---------o-------?----------------------------------------v-
-------------------B---------------------------o------------
-----------------------------------B--------------Eoo-------
-----------o-----------------------?------------------------
--------?------------M-----o--------------?-------B?M-------
-----------?-M---?----?--------------B---M?--------T--------
--------T------------------------------------------|--------
m-------|----------T--------------T---T------T-----|---T----
XXXXXXXXXXXXXXXXXXX|XXXXXXXX--XXXX|XXX|XXXXXX|XXXXX|XXX--XXX
