------------------------------------------------------------
------------------------------------------------------------
------------------------------------------------------------
------------------------------------------------------------
------------------------------------------------------------
------------------------------------------------------------
-------MMMMMMMMMMMMMMMMMMMMMMMMMMMMMMMMMMMMMMMMMMM----------
-------MMMMMMMMMMMMMMMMMMMMMMMMMMMMMMMMMMMMMMMMMMM--------v-
-------MMMMMMMMMMMMMMMEMMMMMMMMMMMEMMMMMMMMMMMEMMM----------
-------MMMMMMEMMMMMMMMMMMMMMMMMMMMMMMMMMMMMMMMMMMM----------
-------MMMMMMMMMMEMMMMMMMMMMMMEMMMMMMMEMMMMMMMMMMMXM--------
-------MMMMMMMMMMMMMMMMMMMMMMMMMMMMMMMMMMMMMMMMMMM----------
-------MMMMMMMMMMMMMMMMMMMMMMMMMMMMMMMMMMMMMMMMMMB----------
-------------------------------------------------------T----
m---------T-------T----------------------------T-------|----
XXXXXXXXXX|XXXXXXX|XXXXXXXXXXXX--XXXXXXXX--XXXX|XXXXXXX|XXXX
