--------------------------------------------------------------------------------
--------------------------------------------------------------------------------
--------------------------------------------------------------------------------
--------------------------------------------------------------------------------
--------------------------------------------------------------------------------
--------------------------------------------------------------------------------
----------?B-----B----?--------------B----B-----B--B-?M-?---------?-----B-------
-------------B-B------------------------M------?----------------?--------------v
----?-------------------BB?---------B-------------B----?------?--------B--------
------?-----------------??-?-B?-?o-?B--------------B-B--------------------------
----B--B----B--BB-------B-B---B-B-----------------------?---?-------------------
-----B-?----------------?----?-----?---?---------B------------BB-----?B---------
-----B--B--?-T----MM-B------?-----?-B-?-BM--?-----B--M-------?------------T-----
-------------|------------------------------------------------------------|-----
m------------|------------------------------------------------------------|-----
XXXXXXXXXXXXX|XXXXX--XXXXXXXXXXXXXXXXXXXXXXXXXXX--XXXXXXXXXXXXXXXXX--XXXXX|XXXXX
