--------------------------------------------------------------------------------
--------------------------------------------------------------------------------
--------------------------------------------------------------------------------
--------------------------------------------------------------------------------
--------------------------------------------------------------------------------
--------------------------------------------------------------------------------
----?---------?----B------B?------------B---?B---B-BB-------B---------B----?----
------------B------B------------?--BB---B------B-----?--------------?----------v
-------------------------B--B--------------------------B---------------B--------
----------B----------?------?-------------?----B----?--?B-----------------------
-------------------?--B------------B--------------BB----------------------------
------B??----------BB------B-----------B-----------------?------?---?B----------
--------?-T-------------------------------?----?----------B---------------------
----------|-----------------------------------------------------------T---------
m---------|------T----------------------------------------------T-----|---------
XXXXXXXXXX|XXXXXX|XXX--XXXXXXXXXXXXXXXXXXXXXXXXXXXXXXXXXXXXXXXXX|XXXXX|XXXXXXXXX
