------------------------------------------------------------
------------------------------------------------------------
------------------------------------------------------------
------------------------------------------------------------
------------------------------------------------------------
------------------------------------------------------------
------------------------------------------------------------
----------------------------------------------------------v-
------------------------------------------------------------
------------------------------------------------------------
------------------------------------------------------------
--------------------------------------------------EE--------
--------------------------------------------------MMM-T-----
------------------------------------------------------|-----
m-----------T-----------------T----T-----------T------|-----
XXXXXXXXXXXX|XXXX--XXXXXXXXXXX|XXXX|XXXXXXXXXXX|XXXXXX|XXXXX
