--------------------------------------------------------------------------------
--------------------------------------------------------------------------------
--------------------------------------------------------------------------------
--------------------------------------------------------------------------------
--------------------------------------------------------------------------------
--------------------------------------------------------------------------------
----?-??----------M------------?---------B---BB---------?-?---?-------B---------
---------B-----o------B-M---------B?-------B--?---?---------?--B--?------------v
-----M----B--?-----M-----------------------B-----?B---------B--------?----------
-----------B-------------?---B----------M-?--M---B-------B----------------------
------------?---------?--------?----------------B--------B--?------B---M-B------
---------------B--?--------------------------B------B-----------------------?---
------------B-----B----------?--------M------B----T----B----------?-------T-----
--------------------------------------------------|-----------------T-----|-----
m-------------------------------------------------|-----------------|-----|-----
XXXXXXXXXXXXXXXXXX--XXXXXXXXXXXXXXXXXXXXXXXXXXXXXX|XXXXXXXXXXXXXXXXX|XXXXX|XXXXX
