------------------------------------------------------------
------------------------------------------------------------
------------------------------------------------------------
------------------------------------------------------------
o?--X---Xo---M-----------X--------X------------oX-----------
----B----------o-o---|-------M-----M--X--X----?-------------
---------------X-?---oB-XB-------------B---M?---E--?--------
-------------B------E--X------------------M-BM-X---------v--
----M---XM--?--------X-----Mo--?--?o---B-MX---M----M-----f--
---X---M-X--X-------X-------X-------?M?--o-E--BE---------f--
--?-----?-----?-------X-M-o-|------?--------M--oM--------f--
B---------|-?-X-?---|M----------EBX--?--M----------------f--
X------------|--|-B-X--X-----M-MM-E-M-----?----XB--------f--
------------------------------------------------------------
m-------------------------------------------------------X-XX
XXXXXXXXXXXXXXXXXXXXXXXXXXXXXXXXXXXXXXXXXXXXXXXXXXXXXXXXXXXX
