--------------------------------------------------------------------------------
--------------------------------------------------------------------------------
--------------------------------------------------------------------------------
--------------------------------------------------------------------------------
--------------------------------------------------------------------------------
--------------------------------------------------------------------------------
------------B----?--?B----------?-------------?-M-?-------------?---?-BB--------
--------B-----??-------?---B----?M--------?----------------?----------B--------v
------------?-B-----?-----?M--------?-?--------------?------------?-B-----------
----?---?--------------------BB-----------------?----------B-------------B------
------?----B--?-----B--?--?-----------B-------------?--B-------------?----------
----------------B---?-------------------?-------?-----?--------?-------M?-------
-------------------------B---B---B----------B----------M-B--------------B-B-----
-----------------T--------------------------------------T-----------------------
m----------------|--------------------------------------|----------------T------
XXXXXXXXXXXXXXXXX|XXXXXXXXXXXXXXXXXXXXXXXXXXXXXXXXXXXXXX|XXXX--XXXXXXX--X|XXXXXX
