------------------------------------------------------------
------------------------------------------------------------
------------------------------------------------------------
------------------------------------------------------------
o?--X---Xo---M---M-------X--------X------------oXX----------
----B----------o-o---|-------M-----M--X--X----?B------------
-------X-------X-?---oB-XB-------------B---M?------?--------
-------------BM-----E--X------------------M-BM-X---------v--
----M---XM--?--------X------o--?--?o---B-MX---M----------f--
---X---M-X--X-------X-------B-------?M?--o-E--BE---------f--
--?-----?-----?-------X-M-o-|------?--------M--oM--------f--
B---------|-?---?X--|M----------EBX--?--M---E------------f--
X------------|--|-B-X--X-----M-MM-E-M-----?----XB--------f--
------------------------------------------------------------
m-------------------------------------------------------X-XX
XXXXXXXXXXXXXXXXXXXXXXXXXXXXXXXXXXXXXXXXXXXXXXXXXXXXXXXXXXXX
