--------------------------------------------------------------------------------
--------------------------------------------------------------------------------
--------------------------------------------------------------------------------
--------------------------------------------------------------------------------
--------------------------------------------------------------------------------
--------------------------------------------------------------------------------
------B----B--B-----M-B-------B--------------------B------B---?--B--------------
-----?------------BB-B-----------B--------?----?----------B-B---------?-B------v
-----BB----B----------BB--------?B----------------B---------B?------------?-B---
-----B----M-B--B---?---BB------B--------?---------B----?----?---?-----------?---
------?--------?--------------------B-------------?-------M-------??------B-----
--------------?----B-----B?----B--B------B-----------?----------?-----------M---
-------------?----------B------------?-------------T---T?---T---BB-------?------
---------------------------------------------------|---|----|-----T-------------
m--------------------------------------------------|---|----|-----|-----T-------
XXXXXXXXXXXXXXXXXXX--XXXXXXXXXXXXXXXXXXXXXXXXXXX--X|XXX|XXXX|XXXXX|X--XX|XXXXXXX
