--------------------------------------------------------------------------------
--------------------------------------------------------------------------------
--------------------------------------------------------------------------------
--------------------------------------------------------------------------------
--------------------------------------------------------------------------------
--------------------------------------------------------------------------------
-------------?-----B---?----------B-B------?----B--------B--B-------------------
-----B---?-----------?-------------------------------?-----------B-------B--B--v
-------B------B---B-?B----------?------?---B---?-B------------------------------
---------------B-------B-B--------------?---?----------B--------?----------?----
--------------?-------?--?---?----B-----?--------B-----B-------M----------B-----
---------B--------------?-------------------?-----B--------------------?---?----
-----------------B--?--------------B--BBB---------------??------B---B-------?---
-----------------------------------------------------------------------T--------
m----------------------------------------------T-----T----------T------|--------
XXXXXXXXXXXXXXXXXXXXXXX--XXXXXXXXXXXXXXXXXXXXXX|XXXXX|XXXXX--XXX|XXXXXX|X--XXXXX
