--------------------------------------------------------------------------------
--------------------------------------------------------------------------------
--------------------------------------------------------------------------------
--------------------------------------------------------------------------------
--------------------------------------------------------------------------------
--------------------------------------------------------------------------------
------------B-?--B-----BM-?----B-------B-?--B------?---------?--B--------B------
------B------M----------BB-----M----------B---------B-B---?----B------------B--v
-----------?B-?-BB?---------------------------M---------?--?----?---------------
-------?----------------?---------------------?---M----?----------?--------B----
-----?--?B------B-B----?------------------------??-----------M------?-----------
----?--B--------B---?--------------B----?---B-??----------?-?------?------------
---------------------------?---?----B-----B--------B----B------T-----T----------
---------------------------------------------------------------|-----|----------
m--------------------------------------------------------------|-----|----------
XXXXXXXXXXXXXXXXXXXXXXXXXXXXXXXXXXXXXXXXXXXXXXXXXXXXXXXXXXXXXXX--XXXX|XXXXX--XXX
