------------------------------------------------------------
------------------------------------------------------------
------------------------------------------------------------
------------------------------------------------------------
------------------------------------------------------------
------------------------------------------------------------
------------------------------------------------------------
---------o-------?----------------------------------------v-
-------------------B---------------------------o------------
-----------------------------------B--------------Eoo-------
-----------o-----------------------?------------------------
--------?--------E-----B----------------o---------B?M-------
-----------?-M---?----?--------------B---M?--------T--------
-------------------------------------T--------T----|--------
m------------------T--------------T--|T------T|----|---T----
XXXXXXXXXXXXXXXXXXX|XXXXXXXX--XXXX|XXX|XXXXXX|XXXXX|XXX--XXX
