--------------------------------------------------------------------------------
--------------------------------------------------------------------------------
--------------------------------------------------------------------------------
--------------------------------------------------------------------------------
--------------------------------------------------------------------------------
--------------------------------------------------------------------------------
--------------------?B---?----------?-------------?-------------BB?-------------
----------------B----------?-??--------B------B------------B----------B--------v
-----BB?-?----?---------?--------?---------?-----B-------------B----------------
-----?B-------------------B-------?----------B----------------------------------
------------?B---------B-----?--?---M--------------?-----------?--B-------------
------------M------B?---??--------B---B-B------------?----------------B?--BB----
------------------------B------B-----------------B----B-BB---B---------B--------
---------------------------------------------------------T---------T------T-----
m--------------------------------------------------------|---------|------|-----
XXXXXXXXXXXXXXXXXXXXXXXXXXXXXXXXXXXXXXXXXXXXXXXXXXXXXXXXX|XXXXXXX--|XXXXXX|XXXXX
