--------------------------------------------------------------------------------
--------------------------------------------------------------------------------
--------------------------------------------------------------------------------
--------------------------------------------------------------------------------
--------------------------------------------------------------------------------
--------------------------------------------------------------------------------
----------B---?--B?------?-?-----------B---------------M----?-----BB?------B----
--------?-??----------?B----------------?--B--------------?--------------------v
------------B--MB---------------?B-------?-?B-?-?------M-----------------B------
------B------B?-----------------M---B---?-------B----MB-----B--?---B-B-----?----
----------------------B-------M-----------?-------------------------------------
---------------BB--?--------------------------------------------------?---------
-------------BB-------?-B---B--------?-------B---?-----B--------B---B?---T------
-------------------T---------------------------------------------T-------|------
m------------------|---------------------------------------------|-------|------
XXXXXXXXXXXXXXXXXXX|XXXX--XXXXXX--XXXXXXXXXXXXXX--XXXXXXXXXXXXXXX|XXXXXXX|XXXXXX
