--------------------------------------------------------------------------------
--------------------------------------------------------------------------------
--------------------------------------------------------------------------------
--------------------------------------------------------------------------------
--------------------------------------------------------------------------------
--------------------------------------------------------------------------------
-------------?----------?-?-?-----------B---------B---------?-----B--?----------
------B-B---?------B--------?---------?----B---B-----------?------?-----?------v
-------?----------?---B------B----------?--?------B-?---M-M---------------------
-------------?-----?---B-B-------?B---B-----?-------------B-------?------B------
-------------------M-B---B----B------?--B-------B--------B-------------B---BB---
-------------?B----B-----------B------------------------------------------------
---------------B----M----------M---M--?-------B--?-----------B----?B---B--------
--------------------------------------------------------------------------T-----
m-----------------------------------T---------------------------T---------|-----
XXXXXXXXXXXXXXXXXXXXXXXXXXXXXXXXXXXX|XXXXXXXXXXXXXXXXXXXXXX--XXX|XXXXXXX--|XXXXX
