--------------------------------------------------------------------------------
--------------------------------------------------------------------------------
--------------------------------------------------------------------------------
--------------------------------------------------------------------------------
--------------------------------------------------------------------------------
--------------------------------------------------------------------------------
----------------------B---B-----?----------------?--------BB-----?--------------
------?-----M---------------?-B---B---B--------M-------------?B-B--------------v
---------?------?----------?-------------------------?-------B------------------
----B---------------------------B-----BB-----------M-------BB---B----------?B---
-------B-?----BB------------?-M----B-----?--------?M------------------?---------
-----------------M---B---------BB---------------B----?---------B----B-----------
--------T?----------------------B------T-----------------?-B-B------------B?----
--------|------------------------------|----------------T----------------T------
m-------|------------------------------|----------------|------------T---|------
XXXXXXXX|XXXXXXXXXXXXXXXXXXXXXXXXXXXXXX|XXXXXXXXXXXXXXXX|XXXXXX--XXXX|XXX--XXXXX
