--------------------------------------------------------------------------------
--------------------------------------------------------------------------------
--------------------------------------------------------------------------------
--------------------------------------------------------------------------------
--------------------------------------------------------------------------------
--------------------------------------------------------------------------------
-----------------------B-------------o-??-------M------------?------------------
----------------------B?--B----?-?-----?-----B---?B--B----B-?------------------v
---------?-----B----------------------------B--------B------------B-B----?--B---
---------B---------------------------------------------------B-----M-B??--------
---------??-----------B-------------------B---------B-------M----------B--------
----?B-------------------MB---------------------------?----?-B-------?----------
-----??-------------?B--------B---------BB------M----B-----B---T-------B--?-----
---------------------------------------------------------------|----------------
m-----------------------------------------T--------------------|-------T--------
XXXXXXXXXXXXXXXXXXXXXXXXXXXXXXXXXXXXXXXXXX|XXXXXXXXXXXXXXXXXXXX|X--XXXX|XXXXXXXX
