------------------------------------------------------------
------------------------------------------------------------
------------------------------------------------------------
------------------------------------------------------------
o?--X---Xo---M---M-------X--------X-o----------oX-----------
----B----------o-o---|-------M-----M--X--X---B?-------------
-------X-------X-?----B-XB-------------B---M?---E--?--------
-----M-------B------E--X-------------?----M-BM-X---------v--
----M---XM--?--------X-----Mo--?--?----B-MX---M----------f--
---X---M-X--X-------X-B-----B-------?M?--o-E--BE---------f--
--?-----?-----?-------X-M-o-|-M----?--------M--oM--------f--
B---------|-?-X-?---|M----------EBX--?--M----------------f--
X------------|--|-B-X--X-----M-MM-E-M-----?--|-XB--------f--
------------------------------------------------------------
m-------------------------------------------------------XXXX
XXXXXXXXXXXXXXXXXXXXXXXXXXXXXXXXXXXXXXXXXXXXXXXXXXXXXXXXXXXX
