--------------------------------------------------------------------------------
--------------------------------------------------------------------------------
--------------------------------------------------------------------------------
--------------------------------------------------------------------------------
--------------------------------------------------------------------------------
--------------------------------------------------------------------------------
----B-??--------------------B--B--------------------------------------?---------
--------B----?--------?---------B------B--------?-BBB--B-M-----------B----B----v
-----?-----B--B--B------------B--?------B------B----------------?-----------B---
-----------------------B---------------------B-?---B----B----------B------------
-----B------------?--------------------??-??---B----?----?--------BB?-----------
------B?--------B-----B------------?-------?-----?----------------------B--B----
-----M-----BT--BBBB?B---B?B----?--?--------------------?---??----------?---M----
------------|--------------------------------------------------------T---T------
m-----------|-----------------------------------T------T-----T-------|---|------
XXXXXXXXXXXX|XXXXXXXXXXXXXXXX--XXXXXXXXXXXXXXXXX|XXXXXX|--XXX|XX--XXX|XXX|XXXXXX
