------------------------------------------------------------
------------------------------------------------------------
------------------------------------------------------------
------------------------------------------------------------
------------------------------------------------------------
------------------------------------------------------------
------------------------------------------------------------
-------------------o--------E-------o---?-----oo----------v-
-------B--Bo-----------------------E---------------E--------
------------------------------------------------------------
-------?--E---E------------?--?----o-------------EE-E-------
---------?--?-----E--------E------?---?B--?------EXXM-------
--------------?----?-?-----BB---T--B-------?-?---o-----T----
----------------T---------------|----------------------|----
m---------------|-------T------------------------------|----
XXXXXXXXXXXXXXXXXXXXXXXX|X--XXXXXXXXXXXXX--XXXXXXXXXXXX|XXXX
