------------------------------------------------------------
------------------------------------------------------------
------------------------------------------------------------
------------------------------------------------------------
----------M?X-M---M-M---X---X---X?------BX-XX--X--X---------
X-E---E-?X-M-----X-ME--M---M----o---?-M---------?X----------
--?-------B---------o--?-------X-o-?--XX--|?----X-----------
-M---?--o--?------M-B--M------o-BX-X-----?-X-B-----------v--
o-------------------X----o-?---------o-o-----?---B-------f--
--B|-------X------X--------B?-----B--MX--MX-----o?-------f--
?-------?-----?M--X-o--------o--X-X----E----------B------f--
-oM--o---oX---B---?--|X-X-M-X-----------M---X----B-------f--
B-|?-M---------M-oX-B?---?-B-X-----o------------o--------f--
---------------------------------------------------------f--
m-------------------------------------------------------XXXX
XXXXXXXXXXXXXXXXXXXXXXXXXXXXXXXXXXXXXXXXXXXXXXXXXXXXXXXXXXXX
