------------------------------------------------------------
------------------------------------------------------------
------------------------------------------------------------
------------------------------------------------------------
o---X---Xo---M---M-------X--------X------------oXX----------
----B----------o-o---|-------M-----M--X--X---B?B------------
-------X-------X-?---oB-XB---?---------B---M----E--?--------
-------------BM-----E--X-------------?----M-BM-X---------v--
----M---XM--?--------------Mo--?--?------MX---M----------f--
---X---M-X--X-------X-B-----X-------?M?--o-E--BE---------f--
--?-----?-----?-------X-M-o-|-M----?--------M--oM--------f--
B---------|-?-X-?X--|M----------EBX--?--M----------------f--
X------------|--|-B-X--X-----M-M--E-M-----?--|-XB--------f--
------------------------------------------------------------
m-------------------------------------------------------XXXX
XXXXXXXXXXXXXXXXXXXXXXXXXXXXXXXXXXXXXXXXXXXXXXXXXXXXXXXXXXXX
