------------------------------------------------------------
------------------------------------------------------------
------------------------------------------------------------
------------------------------------------------------------
------------------------------------------------------------
------------------------------------------------------------
------------------------------------------------------------
------------------------------------------?-------E-------v-
--------B-----o--o----oE----------?-------E--------EE-------
------------E---E---------o---o-----------------------------
---------------o---------o-------E----------?------E?-------
--------E------------B---?-----------?------------MB--------
---------------?-------?-?----------B----?------------------
------------------------------------------------------------
m-------------------T-------T-------------T-----------------
XXXXXXXXXXXXXXXXXXXX|--XXXXX|XXXXXXXXXXXXX|--XXXXXXXXXXXXXXX
