------------------------------------------------------------
------------------------------------------------------------
------------------------------------------------------------
------------------------------------------------------------
------------------------------------------------------------
------------------------------------------------------------
------------------------------------------------------------
--------------------------------------------------------v---
--------------------------------------------------------f---
-------BoooBoooooooooooooooooooooooooooBoooooooBoo------f---
--------------------------------------------------------f---
--------------------------------------------------------f---
--------------------------------------------------------f---
--------------------------------------------------------f---
m-------------------------------------------------------X---
XXXXXXXXXXXXXXXXXXXXXXXXXXXXXXXXXXXXXXXXXXXXXXXXXXXXXXXXXXXX
