------------------------------------------------------------
------------------------------------------------------------
------------------------------------------------------------
------------------------------------------------------------
--?-E-----?X--------M------X-?------?--B-o----?---B---------
----XM--B-----X---X-----B-?------B---M----------------------
-|--------M--XM---BX-B--?--B------oX----X-BoXE?----B--------
--X------M-?-X--------E---XX--M----MX-M-----o---MM-E-----v-v
-?--X--M-----M----M-B------------?--------------o--------f-f
------E-------X-M?---------?-----?--M?X-----X-oM---------f-f
-------XX---M--M?-----XB----------------B-----M-X--------f-f
--M-----B---E---B---E-M|------?---------B------M--B------f-f
-------?-----M---E--?BM---?----B-?--?-?-----B------------f-f
---------------------------------------------------------f-f
m-------------------------------------------------------XXXX
XXXXXXXXXXXXXXXXXXXXXXXXXXXXXXXXXXXXXXXXXXXXXXXXXXXXXXXXXXXX
