--------------------------------------------------------------------------------
--------------------------------------------------------------------------------
--------------------------------------------------------------------------------
--------------------------------------------------------------------------------
--------------------------------------------------------------------------------
--------------------------------------------------------------------------------
--------?--B-----?-----B-----?----B---B----------------B-----------?------------
---------------------------B-B--B------?B-B--M--------?-------BB----B----------v
--------?-----------------------B-----------------B----B----------B-M-----?B----
-----------?------?----?-----?-B----------B------B------------------------B-----
------B---B-----BB--------------?------------B----------------------M-----------
-------M----?-------------------------o------------?-B---?---------?------------
-----------------------B----------------B-------?--------B------B-----------M---
--------------------------------------------------------------------T-----------
m-------------------------------------------------------------------|-----------
XXXXXXXXXXXXXXXXXXXXXXXX--XXXXXXXXXXXXXXXXXXXXXXXXXXXXXXXXXXX--XXXXX|XXXXXXX--XX
