--------------------------------------------------------------------------------
--------------------------------------------------------------------------------
--------------------------------------------------------------------------------
--------------------------------------------------------------------------------
--------------------------------------------------------------------------------
--------------------------------------------------------------------------------
-----B----?-?----?----B-B---B-----B-----------------------M----------BB-----?---
-----------?--B------?---?----B---B-------B--B----B-----?---------B--B---------v
----------B-B----?---B------M------------------------------------?----------B---
---------------?--------?------?-----?------B----B---B?-B---?-------B-B---------
--------B--?-------------?---B-----------?---?----M?---------?-----M--B-?-?-----
---------------?--------B-----------------------B-------------------------------
-----------------------?--------M-----------------------?------TB----?----------
---------------------------------------------T-----------------|----------------
m----------T---------------------------------|-----------------|----------------
XXXXXXXXXXX|XXXXXXXXXXXXXXXXXXXXXXXXXXXXXXXXX|XXXXXXXXXXXXXXXXX|--XXXXXXXXXX--XX
