--------------------------------------------------------------------------------
--------------------------------------------------------------------------------
--------------------------------------------------------------------------------
--------------------------------------------------------------------------------
--------------------------------------------------------------------------------
--------------------------------------------------------------------------------
-----------B-B-----B------?--------B------------------?--------------------B----
----B-------B-B--------------------B-------B----------B------B-B---B---?-------v
------------??--B------------?--??----------------------------------?-----------
-----B-------------------B------------B--B-----B----B------------B?B------------
-----B---M---------------B----B-----B--B-------------------?--------------------
-----?----------?--------------------B------?-----B--------------?--------------
-----B-B-------B----------B---------B---?-------------?--------T-----B------?---
---------------------------------------------------------------|----------------
m--------------------------------------------------------------|----------T-----
XXXXXXXXXXXXXXXXXXXXXXXXXXXX--XXXXXXXXXXXXXXX--XXXXXXXXXXXXXXXX|XXXXXXXXXX|XXXXX
