------------------------------------------------------------
------------------------------------------------------------
------------------------------------------------------------
------------------------------------------------------------
------------------------------------------------------------
------------------------------------------------------------
-------ooooooooooooooooooooooooooooooooooooooooooo----------
-------Bo-------------E--------------o------E---o-o-------v-
--------------------------------------------------oEo-------
--------------------------------------------------o---------
------------------------------------------------------------
------------?-B-?-E-------------------------------Eo--------
---------------B-----------------B----------B-----X?M--T----
-------------------------------T-----------------------|----
m------------------------------|-----------T-----T-----|----
XXXXXXXXXXXXXXXXXX--XXXXXXXXXXXXXXXXXXXXXXX|XXXXX|XXXXX--XXX
