--------------------------------------------------------------------------------
--------------------------------------------------------------------------------
--------------------------------------------------------------------------------
--------------------------------------------------------------------------------
--------------------------------------------------------------------------------
--------------------------------------------------------------------------------
----?--B--?--?-B?-----------?-------MB---?-------?---B--------------?-----------
--------------?-?-----------------?------------?-----?B-------------------B----v
----B---M--B----------?-B-B----------------------------B----------?----?--------
-------------------------------------------?B-------------------?---------------
----------------?--------------?-----?B---M-B------?--B---B------B--B-----------
-------------------------?--------?-------------B----------?--B------B-B--------
----------------------------------B----------B---?--B----BB----?---------?------
-----------------------------T----------T---------------------------------------
m----------------------------|----------|--------------------------------T------
XXXXXXXXXXXXXXXXXXXXXXXXXXXXX|XXXXXXXXXX|XXXX--XXXXXXXXXX--XXXXXXXXXX--XX|XXXXXX
