--------------------------------------------------------------------------------
--------------------------------------------------------------------------------
--------------------------------------------------------------------------------
--------------------------------------------------------------------------------
--------------------------------------------------------------------------------
--------------------------------------------------------------------------------
--------------------B----?--------------------------------B--------??-----------
---------------------?-----B-------------?---------B---------------------------v
----------?-------M---?-----?BB----------------B-------?----------------B-------
--------------?---------------B--------B----BB-----?-B--------??-------BB--B----
-----B--------B---------------?-------------B--------------B-----?-?--M-----?---
--------------------MB----B--M-----B-------B-?-----------------B----?-----B-----
-----BB---B--?-------------?--------B--B---?---B----B------?--------T--?---T----
--------------------------------------------------------------------|------|----
m------------------------------------------------------------T------|------|----
XXXXXXXXXXXXXXXXXXXXXXXXXXXXX--XXXXXXXXXXXXXXXXXXX--XXXXXXXXX|XXX--X|XXXXXX|XXXX
