------------------------------------------------------------
------------------------------------------------------------
------------------------------------------------------------
------------------------------------------------------------
----------M?X-----MXM---X---XX--X?------BX-XX--X--X---------
X-E---E-?--M-----X-ME--M---M--?-o---?-M---------?XB---------
--?-------B---------o--?-------X---?--XX--|?----X-----------
-M---?B-o--?------M-B--M------o-BX-X-----?-X-B-----------v--
oX------M-----------X----o-----------o-o---------B-------f--
--B|-------X-?o---X--------B?---X-B--MX--MX-----o?-------f--
?-------?-----?M--X-o--------o--X-X----E----------B------f--
-oM--o---oX---B---?--|X-X-M-X---------X-M---X------------f--
B-|?-M---?-----M-oX-B?---?-B-X-----o------------o--------f--
---------------------------------------------------------f--
m-------------------------------------------------------XXXX
XXXXXXXXXXXXXXXXXXXXXXXXXXXXXXXXXXXXXXXXXXXXXXXXXXXXXXXXXXXX
