------------------------------------------------------------
------------------------------------------------------------
------------------------------------------------------------
------------------------------------------------------------
------------------------------------------------------------
------------------------------------------------------------
------------------------------------------------------------
---------o-------?----------------------------------------v-
-------------------B---------------------------o------------
-----------------------------------B--------------EE--------
-----------o-----------------------?------------------------
--------?--------E-----B----------------o---------o---------
-----------?-M---?----?--------------B---M?-------BMT-------
-------------------------------------T--------T-----|-------
m------------------T--------------T--|T------T|-----|-------
XXXXXXXXXXXXXXXXXXX|XXXXXXXX--XXXX|XXX|XXXXXX|XXXXXX|XXXXXXX
