------------------------------------------------------------
------------------------------------------------------------
------------------------------------------------------------
------------------------------------------------------------
------------------------------------------------------------
------------------------------------------------------------
------------------------------------------------------------
-------?--------------------------?--------B------o-------v-
--------------------------------------------------oEo-------
-------BoooBoooooooooooooooooooooooooooBoooooooBooo---------
--------------------o------E---B------------E---------------
--------------------------------------------------Eo--------
--------------------------------------------------X?M--T----
-------------------------------T-----------------------|----
m------------------------------|-----------T-----T-----|----
XXXXXXXXXXXXXXXXXX--XXXXXXXXXXXXXXXXXXXXXXX|XXXXX|XXXXX--XXX
