--------------------------------------------------------------------------------
--------------------------------------------------------------------------------
--------------------------------------------------------------------------------
--------------------------------------------------------------------------------
--------------------------------------------------------------------------------
--------------------------------------------------------------------------------
------B--------?-----------?----B--?------------?-------B-------B----------?----
-------------M----B------B--B----?-----------?B---------B-?B-------------------v
-------BB----B?B---------------------?-----?----------B---B--B--M-----------?---
-----B------?----------B---------------------B--B?--?-------------M-------------
------------------?----------------B----?---B----------------B-------?--?-------
----?--B----------------??-------------?-B-------B-------B--------------?-------
-------------M------?-----?-------T----B--------B--B----?--------------T--------
----------------------------------|------------------------------------|---T----
m---------------------------------|------T-----------------------------|---|----
XXXXXXXXXXXXXXXXXXXXXXXXXXXXXXXXXX|X--XXX|XXXXXXXXXXXXXXXXXXXXXXXXXXXXX|XXX|XXXX
