--------------------------------------------------------------------------------
--------------------------------------------------------------------------------
--------------------------------------------------------------------------------
--------------------------------------------------------------------------------
--------------------------------------------------------------------------------
--------------------------------------------------------------------------------
-----?---?---?----------B---?----------------B--B-------B------------?----------
-------------?--?---BB---??B--------------B---------------B-B-?--------B?------v
------------?-----?B-?------B----B------B-------------?B-------?----?-----------
----?------------------B---------------------------------?-?-------?-----BB-----
------?B-------B--------------------B---B---B----------B--B---------??----------
---------------------------------------?-----B-------?---BB------------?--------
-----------------------------?--------B---------------?--B---?BB--B---M---------
---------------------------------------------------------------------------T----
m--------------------------------------------------------------------------|----
XXXXXXXXXXXXXXXXXXXXXXX--XXXXXXXXXX--XXXXXXXXXXXXXXXXXXXXXXXXXXXXXXXXXXXXXX|XXXX
