------------------------------------------------------------
------------------------------------------------------------
------------------------------------------------------------
------------------------------------------------------------
-E--------XB------E------B-----B-X---B--E-BM---BX-----------
----------XX-------B-E--------??------------EM--------------
M------X-------X---?--MoB-|B---o--B-----------|---?---------
--X-----?----o----?---X|--B---X---------E--------X-?-----v--
M-oE--?-X--------B-----E?-M-E-----------------B----------f--
----X----------?MM-?----------?-|X------X-B--------?-----f--
--X--?----M-X----M------?-M?-------B------------X--------f--
-X--------------X-B-X---B--------B|o---?-o--?------------f--
--X------X------B--BBB-X----?----?----------------o------f--
---------------------------------------------------------f--
m-------------------------------------------------------XXXX
XXXXXXXXXXXXXXXXXXXXXXXXXXXXXXXXXXXXXXXXXXXXXXXXXXXXXXXXXXXX
