--------------------------------------------------------------------------------
--------------------------------------------------------------------------------
--------------------------------------------------------------------------------
--------------------------------------------------------------------------------
--------------------------------------------------------------------------------
--------------------------------------------------------------------------------
----------?-B-------?---?-B------M--M-B-----B-?------------??----------?--------
----?----------?---B-----------------------------------?M--?-?----------?-B----v
------B-B-----B---B--------------------B---------?B-------BB----------------B---
-----B---------------?-----------------?--?---------------B--------M---?--------
--------?--------B-----------M---?------?-----B----------------------B----------
--------------M-----?------?---------------?------------------------??------B---
----?---------------BBB-?----B--?---B---------------M-?----B-----T----?-T---B---
-----------------------------------------------------------------|------|-------
m----------------------------------------------------------------|------|-------
XXXXXXXXXXXXXXXXXXXXXXXXXXXXXXXXXXXXX--XXXXXXXXXXXXXXXXXXXXXXXXXX|XXXXXX|XXXXXXX
