------------------------------------------------------------
------------------------------------------------------------
------------------------------------------------------------
------------------------------------------------------------
--|-?-M----XXXB-X----X-------------??-MB---------B----------
---E-?--------X--M------X-?------B----?--X----X----M--------
-|----o------X-------o--?XMX-------X-X----E------?-X--------
X--X-------?-?----------o--X--M--M---------XB-----X---------
-o--XX-Mo---------M--------XM--------M----------oXB|-----f--
-B------------------EM----X-----------?-----------|------f--
-----B--B-?------X---o-------M--B-B-X---------o-X--------f--
-----B-MB------X------M------X-----B-----X--|MBX---------f--
---M-M---M-----M--------E--BX--M-X-------------?-B-------f--
---------------------------------------------------------f--
m-------------------------------------------------------XXXX
XXXXXXXXXXXXXXXXXXXXXXXXXXXXXXXXXXXXXXXXXXXXXXXXXXXXXXXXXXXX
