--------------------------------------------------------------------------------
--------------------------------------------------------------------------------
--------------------------------------------------------------------------------
--------------------------------------------------------------------------------
--------------------------------------------------------------------------------
--------------------------------------------------------------------------------
---------B--------?-----?B---B---B--?---------------B----B-----??-B---B---------
-----B--B---?---B-B-------B--------?---B---?--------?--B--------------------B--v
-----------B---?B--BB-----B-B-B-----B-B--------------------B-------B--------?---
---------?---------B-------?----------?----------?------------------B-------B---
----?------?-B---?-B---?------M----------?--------B--------B----------?-M---M---
-------------?----------------------?-------?-----------------B----------B--M---
----?-------B-----B---------------B-?-----?-----B--B----------------B-----T-----
-----------------------------------------------T---T----------------------|-----
m----------------------------------------------|---|--------T-----T-------|-----
XXXXXXXXXXXXXXXXXXX--XXXXXXX--XXXXXXXXXXXX--XXX|XXX|XXXX--XX|XXXXX|XXXXXXX|XXXXX
