--------------------------------------------------------------------------------
--------------------------------------------------------------------------------
--------------------------------------------------------------------------------
--------------------------------------------------------------------------------
--------------------------------------------------------------------------------
--------------------------------------------------------------------------------
-----?-------------B?---------B----------M-------------?-----?-----?------------
--------B--------?--M-B--?-?--?-?---------B-?-------M-------------B------?-----v
--------------??--B------------?--------------------------------?--B--?---------
----------------------------B-B----B--B?M--------B-B-----?---?-?-?B--M----------
---------------B------B----B---------------?---B------------?---?---------------
-----------?------------------------------?----B-------?--B------B----------B---
-------B-----------?----------?--------B-B---B------------T---------?------T----
----------------------------------------------------------|---------T------|----
m---------------------------------------------------------|-----T---|------|----
XXXXXXXXXXXXXXXXX--XXXXXXXXXXXXXXXXXXXXXXXXXXXXXXXXXXXXXXX|XXXXX|XXX|XXXXXX|XXXX
