--------------------------------------------------------------------------------
--------------------------------------------------------------------------------
--------------------------------------------------------------------------------
--------------------------------------------------------------------------------
--------------------------------------------------------------------------------
--------------------------------------------------------------------------------
----------B-----B---------B----?----?-----B-------B------?---------B-?----------
-----BB--M---------B--?--------------B-----------?---?-?B-----------??---------v
-------------------?-------B-B?--------B--B-----?--------M---M------------------
----B---?-B----o-------------------------------------?-------B---------?--------
-------------B----?------------?-----------------------?--B-B?-M-M--?-----------
--------?-----------?----------?--B------------------B-----------?---?----------
--------?----------------B-B------?-------------?-----?-------------?----?------
------------------------------------------------------T----T--------------------
m-------------------------------------------------T---|----|---------T----------
XXXXXXXXXXXXXXXXXXXXXXXXXXXXXXXXXXXXXXXXXXXXXXXXXX|XXX|XXXX|X--XXXXXX|XXXXXX--XX
