--------------------------------------------------------------------------------
--------------------------------------------------------------------------------
--------------------------------------------------------------------------------
--------------------------------------------------------------------------------
--------------------------------------------------------------------------------
--------------------------------------------------------------------------------
-----?--------------B?--B----------------B--?-?-------------------B-------------
----------------?--?-----B-----------------??-------------BM------?------------v
-------------------?B------?--------?B---------M---B----------------------------
-------------?-----?---------?---?--B------------------?------B----------B?-----
----------?------------------?---------B---?--M------------B--------------------
----?---?M-----B?-----------------M-----------B-------B-------------M-----------
------------------B-----?-------------M-?------------B-------TB?---B------------
-------------------------------------------------T-----------|------------------
m------------------------------------------------|-----------|----T----T--------
XXXXXXXXXXXXXXXXXXXXXXXXXXXXXXXXXXXXXXXXXXXXXXXXX|XXXXXXX--XX|XXXX|X--X|XXXXXXXX
