------------------------------------------------------------
------------------------------------------------------------
------------------------------------------------------------
------------------------------------------------------------
-E------X-XB------E------B-----B-X---B--E-BM---BX-----------
----------XX-------B-E--------??-------X--X-EMX-------------
-------X-------X---?--Mo--|B---o--B-----------|---?---------
--X-----?----o----?---X|--B---X---------E--------X-?-----v--
--oE--?-X--------B-----E?-M-?-----------------B----------f--
M---X----------?MM-?----------?-|X------X-B--------?-----f--
--X--?----M-X----M------?-M?-------B------------X--------f--
BX--------------X---X---B--------B|o---?-o--?------------f--
--X------X------B--BBB-X----?-?--?----------------o------f--
---------------------------------------------------------f--
m-------------------------------------------------------XXXX
XXXXXXXXXXXXXXXXXXXXXXXXXXXXXXXXXXXXXXXXXXXXXXXXXXXXXXXXXXXX
