--------------------------------------------------------------------------------
--------------------------------------------------------------------------------
--------------------------------------------------------------------------------
--------------------------------------------------------------------------------
--------------------------------------------------------------------------------
--------------------------------------------------------------------------------
-----B--?------B--?-----------B---?---B-------------B-----B---?--------B-?------
-------??------------?B-?M------??B---?--B-----B-------------B--B-------?B-----v
--------------BBM-B---------?-------------B-------?----------------B-------B----
--------?-----------?-----------?---------------------B--?-------------B--------
--------------?-----?--------------B-B--------?----B---------------------B--?---
------------B-------------------------------B--------B-----B-?---?o-----B-------
--------------------B--------?--B-B--------------------T--------B--?-?------B---
-------------------------------------------------------|---T--------------------
m----------------------------------------T-------------|---|------T--------T----
XXXXXXXXXXXXXXXXXXX--XXXXXX--XXXXXXXXXXXX|XXXXXXXXXXXXX|XXX|XXXXXX|XXXXXXXX|XXXX
