------------------------------------------------------------
------------------------------------------------------------
------------------------------------------------------------
------------------------------------------------------------
------------------------------------------------------------
------------------------------------------------------------
-------BBBBBBBBBBBBBBBBBBBBBBBBBBBBBBBBBBBBBBBBBBB----------
-------BBBBBBBBBBBBBBBBBBBBBBBBBBBBBBBBBBBBBBBBBBBo-E-----v-
-------BBBBBBBBBBBBBBBBBBBBBBBBBBBBBBBBEBBBBBBBBBEX??-------
-------BBBBBBBBBBBBBBBBBBBBBEBBBBBBBBBBBBBBBBBBBEE----------
-------MMMMMMMMMMEMMMMMMMMMMMMEMMMMMMMEMMMMMMMMMMM----------
-------BBBBBBBBBBBBBBBBBBBBBBBBBBBBBBBBBBBBBBBBBBB----------
-------BBBBBBBBBBBBBBBBBBBBBBBBBBBBBBBBBBBBBBBBBB-BBB-------
-------------------------------------------------------T----
m---------T-------T----------------------------T-------|----
XXXXXXXXXX|XXXXXXX|XXXXXXXXXXXX--XXXXXXXX--XXXX|XXXXXXX|XXXX
