------------------------------------------------------------
------------------------------------------------------------
------------------------------------------------------------
------------------------------------------------------------
------------------------------------------------------------
------------------------------------------------------------
------------------------------------------------------------
----------------------E----------E---------o------o-------v-
-------M------E------------------------B---------EoEo-------
-------B-------------------E-------------------E--o---------
------------------------------------------------------------
--------------------------------------------------Eo--------
------------??----------?-------?----------------BX?M--T----
-------------------------------------------------------|----
m-----------T-----------------T----T-----------T-------|----
XXXXXXXXXXXX|XXXX--XXXXXXXXXXX|XXXX|XXXXXXXXXXX|XXXXXXX--XXX
