--------------------------------------------------------------------------------
--------------------------------------------------------------------------------
--------------------------------------------------------------------------------
--------------------------------------------------------------------------------
--------------------------------------------------------------------------------
--------------------------------------------------------------------------------
----------B-----B-----B?-----?--M--------B------B----BM---B-------------B---B---
---------------------------B-------?---?BB-B-----------------------?--?--------v
-----?-?--------M---------------B--B----------------B-------?-----M-----M-------
-------?B-------B--B-----B-------?--?-------B?---?--------------?---------B-----
-------------M-------?--------------B-------B------------------------?----------
--------------B?B--------------B-?-----B--------------B--------?--B-------------
------------B-B?-----M-B----?--------B---------?--------B-B-------?B--?---?-----
--------------------------------------------------------------------T---T-------
m------------------------------------------------------------T------|---|-------
XXXXXXXXXXXXXXXXXXXX--XXXXXXXX--XXXXXXXXXXXXXXXXXXXXXXX--XXXX|XXXXXX|XXX|XXXXXXX
