------------------------------------------------------------
------------------------------------------------------------
------------------------------------------------------------
------------------------------------------------------------
----------M?X-----MXM---X---X---X?-------X-XX--X--X---------
X-E---E-?--M-----X-ME--M---M--?-o---?-M---------?XB---------
--?-------B---------o--?-------X---?--XXo-|?----X-----------
-M---?B-o---------X-B--M------o-BX-X-----?-X-B-----------v--
oX------------------X----o---?-------o-o-----?---B-------f--
--B|-------X-?o---X--------B?-----B--MX--M------o?-------f--
?---------M---?M--X-o-B------o--X-X----E----------B------f--
-oMX-o---oX---B---?--|X-X-M-X---------X-M---X----B-------f--
B-|?-M---?--B--M-oX-B?---?-B-X-----o------------o--------f--
---------------------------------------------------------f--
m-------------------------------------------------------XXXX
XXXXXXXXXXXXXXXXXXXXXXXXXXXXXXXXXXXXXXXXXXXXXXXXXXXXXXXXXXXX
