------------------------------------------------------------
------------------------------------------------------------
------------------------------------------------------------
------------------------------------------------------------
---o--?--E?----------|-------------B-X--X-?--|----B---------
XoMEB---------E-----------?-----B----M----XX----------------
-|--o-?-X----------X-B---X---E--X-------X------o------------
----------------?---------XM--E--MX--XM----B-----M?------v--
-BEM-----?B----------E----XoM--M------------M--?---B-----f--
-B------?----------?EM----------M?----?-X---XMBM--M------f--
BX---o-BEX?-------?X---|-----B---M-M------o-----X--X-----f--
--ME---X-BB--B--------M---?--X---X-X-|-----M|-B?-X----------
---X-M-?-----------M?---Mo-----B----?------M-MX----?-----f--
---------------------------------------------------------f--
m-------------------------------------------------------XX-X
XXXXXXXXXXXXXXXXXXXXXXXXXXXXXXXXXXXXXXXXXXXXXXXXXXXXXXXXXXXX
