------------------------------------------------------------
------------------------------------------------------------
------------------------------------------------------------
------------------------------------------------------------
------------------------------------------------------------
------------------------------------------------------------
------------------------------------------------------------
--------------------------------------------------------v---
-------------o--o-----------------------o----o----------f---
-------ooooooooooooooooooooooooooooooooooooooooooo------f---
--------------------------------------------------------f---
--------------------------------------------------------f---
--------------------------------------------------------f---
--------------------------------------------------------f---
m-------------------------------------------------------X---
XXXXXXXXXXXXXXXXXXXXXXXXXXXXXXXXXXXXXXXXXXXXXXXXXXXXXXXXXXXX
