------------------------------------------------------------
------------------------------------------------------------
------------------------------------------------------------
------------------------------------------------------------
------------------------------------------------------------
------------------------------------------------------------
------------------------------------------------------------
---------------------------------------------------oo---v---
--------------------------------------------------------f---
-------------o-----------------E------M---------??------f---
------------E---E----------------B-B--------------ooE---f---
--------?B------------M-------?------------B---M--EEE---f---
-------oooooooooooooooooooooooooooooooooooooooooooM?B---f---
----------------------------------------------------T---f---
m---------T----------------------T------------------|---X---
XXXXXXXXXX|XXXXXXXXXXXXXXX--XXXXX|XXXXXXXXXXXXXXXXXX|XX-XXXX
