------------------------------------------------------------
------------------------------------------------------------
------------------------------------------------------------
------------------------------------------------------------
------------------------------------------------------------
------------------------------------------------------------
------------------------------------------------------------
-------Bo-------------E--------------o------E---o-o-------v-
--------------------------------------------------oEo-------
--------E-----------?-o---------------------o-----o---------
------------------------------------------------------------
--------------------------------------------------Eo--------
---------------B-----------------B----------B-----X?M--T----
-------------------------------T-----------------------|----
m------------------------------|-----------T-----T-----|----
XXXXXXXXXXXXXXXXXX--XXXXXXXXXXXXXXXXXXXXXXX|XXXXX|XXXXX--XXX
