------------------------------------------------------------
------------------------------------------------------------
------------------------------------------------------------
------------------------------------------------------------
----------M?X-----M-----X---X---X?------BX-XX--X--X---------
X-E---E-?--M-----X-ME--M---M----o---?-M---------?X----------
--?-------B---------o--?-------X-o-?--X-o-|?----X-----------
-M---?--o--?------M-B--M------ooBX-X-----?-X-B-----------v--
oX------M-----------X----o-?---------o-o---------B-------f--
--B|-------X--o---X-------XB?---X-B--MX--M------o?-------f--
?-------?-M---?M--X-o--------o--X-X----E----------B------f--
-oM--o---oX---B---?--|X-X-M-X---------X-M---X----B-------f--
B-|?-M---?-------oX-B?---?-B-X-----o---------------------f--
---------------------------------------------------------f--
m-------------------------------------------------------XXXX
XXXXXXXXXXXXXXXXXXXXXXXXXXXXXXXXXXXXXXXXXXXXXXXXXXXXXXXXXXXX
