--------------------------------------------------------------------------------
--------------------------------------------------------------------------------
--------------------------------------------------------------------------------
--------------------------------------------------------------------------------
--------------------------------------------------------------------------------
--------------------------------------------------------------------------------
-------B-------?--------B-----B---B---?--------B----------------------------?---
----?---?----?-----------?-----BB-----B-----------B-----------B-----B----------v
--------------?----?------------------B------------B---?---B--------?-----------
-----?--------BB--B------------------?-----------------?------?-------?----B----
-----------BB------M----B-----BB--------------M-----------B------M----B-----B---
-----?------------B-------B---?----------?B-------B-?--------B----?-------------
---------B------?--BB------T----------------------------BB------------?---?T----
---------------------------|-----------------------------------------------|----
m--------------------------|-----------------------------------------------|----
XXXXXXXXXXXXXXXXXXXXXXXXXXX|XXXXXXXXXXXXXXXXXX--XXXXXXXX--XXXXXXXXX--XXXXXX|XXXX
