------------------------------------------------------------
------------------------------------------------------------
------------------------------------------------------------
------------------------------------------------------------
------------------------------------------------------------
------------------------------------------------------------
------------------------------------------------------------
-------B--------E-E------?----?--------o-------E--------v---
--------------------------------------------------------f---
--------------------------------------------------------f---
-------oBooooooooooooBoooooooooooooooooooooooooooo------f---
--------?B------------M-------?------------B---M--------f---
-------ooBooBoooooooooooBooooooooooooBBoooBooooooo------f---
--------------------------------------------------------f---
m------------------------------------------------T------X---
XXXXXXXXXXXXXXXXXXXXXXXXXXXXXXXXXXX--XXXXXXXXXXXX|XXXXXXXXXX
