--------------------------------------------------------------------------------
--------------------------------------------------------------------------------
--------------------------------------------------------------------------------
--------------------------------------------------------------------------------
--------------------------------------------------------------------------------
--------------------------------------------------------------------------------
----?--B------------B--M----------------B----?B-B-----?---------B------?--------
-------------?---?-----?---B-----?---------BB-B?----------------------B--------v
----B---------?------------?--?--------------B-B--------------------------------
------------------??----------?------B-----------------------------?------------
--------B------B------------------?------------?----M-?B-B?---------------------
----------------------------B-------??-----B------------------------------------
--------B---?-B--------?-------B------?----?---B-TB---T--B---------B--T----T----
-------------------------------------------------|----|---------------|----|----
m------------------------------------------------|----|---------------|----|----
XXXXXXXXXXXXXXXXXXXXXXXXXXXXXXXXXXXXXXXXXXXX--XXX|XXXX|XXXX--XXXXXXXXX|XX--|XXXX
