--------------------------------------------------------------------------------
--------------------------------------------------------------------------------
--------------------------------------------------------------------------------
--------------------------------------------------------------------------------
--------------------------------------------------------------------------------
--------------------------------------------------------------------------------
----B?-?-------------B------?--B----?-----------------?--------o-B-------B------
-----B-------------B------M------------------B--------?---------B------?-------v
-----B?------?--------M-------B----B----B--------?--------------M---------------
----------B------B-B--------?------------B-------------B-----B----B--M-----?----
-------------?--M---?--------------B---BB----------BB-------------------B-------
-----B?------?---?----B---------------------------?----?-------?-----------M----
---------?--------------B----------------?----------?---?-------------B??T-?B---
-------------------------------------------------------------------------|------
m----------------------------------------------------------------T-------|------
XXXXXXXXXXXXXXXXXXXXXXXXXXXXXXXXXXXXXXXXXXXXXXXXXXXXXXXXXXXXXXXXX|--XXXXX|XXXXXX
