--------------------------------------------------------------------------------
--------------------------------------------------------------------------------
--------------------------------------------------------------------------------
--------------------------------------------------------------------------------
--------------------------------------------------------------------------------
--------------------------------------------------------------------------------
--------------------B------B------?---------------?----?-?-------B-B------------
--------B--------B--------?-B-?-?B---------------------------------B-----B-----v
-------B--------------?---------?--BB-----------B-------------------------------
----BB---?----B--B----B----?------??--B----------------B-------B-?--------------
----?----?--------------?-B----M-?----B--B------------B-------------------------
-----BB-MM--------B-?B---------B----------?-------------?------?-B--B--B-?------
---------------?-----------------B??--------------?----------?B-------B--?-B----
-------------------------------------------------------T------T----T------------
m------------------------------------------------------|------|----|------------
XXXXXXXXXXXXXXXXXXXXXXXXXXXXXXXXXXXXXXXXXXXXX--XXXXXXXX|XXXXXX|XX--|XXXXXXXXXXXX
