------------------------------------------------------------
------------------------------------------------------------
------------------------------------------------------------
------------------------------------------------------------
------------------------------------------------------------
------------------------------------------------------------
------------------------------------------------------------
-------Bo-------------E--------------o------E---o-o-------v-
--------------------------------------------------oEo-------
-------oooooooooooooooooooooooooooooooooooooooooooo---------
------------------------------------------------------------
------------B-M-B-E-------------------------------Eo--------
----------------M---M--------------------M-B------X?M--T----
-------------------------------------------------------|----
m------------------------------------------T-----T-----|----
XXXXXXXXXXXXXXXXXX--XXXXXXXXXXXXXXXXXXXXXXX|XXXXX|XXXXX--XXX
