--------------------------------------------------------------------------------
--------------------------------------------------------------------------------
--------------------------------------------------------------------------------
--------------------------------------------------------------------------------
--------------------------------------------------------------------------------
--------------------------------------------------------------------------------
----?BB---B----B----------------??----B---?------B--------B---------------?-----
--------?----MBB-----?--B---?-B-------B-------------?-?-----?-B----------------v
------?-----------------?----?------B----------?-B--------------------B----??---
---------B----------?------?----?--B-------------B?-------BB----?---------------
----M--?------------------------------------B---B-------B----B------------------
-------?----B--B-----?-----------------------------------------------B----------
---------------------------B-----?B--?-T------B-------M----------------?B-------
---------------------------------------|------------T-------------T----T--------
m--------------------------------------|------------|--------T----|----|--------
XXXXXXXXXXXXXXXXXXXXXX--XXXXXXX--XXXXXX|XXXXXXXXXXXX|XXXXXXXX--XXX|XXXX|XXXXXXXX
