--------------------------------------------------------------------------------
--------------------------------------------------------------------------------
--------------------------------------------------------------------------------
--------------------------------------------------------------------------------
--------------------------------------------------------------------------------
--------------------------------------------------------------------------------
----------?----?----------MB--?----B----------B?-B--B-?---B-----------?-----?---
-----M-?B-----?-B--B---?-------------------B-------B-----BB--?-------?---------v
-------B---?BM------------?---B--------B-----------?---?----B-B-------------B---
-------------?-----?----B-----B-B--?B-----B------?---B-------B-B---?------------
------BB---?--------?---??---------------------B--?-----B-------------M?--------
------------------B---B-------?---B--------------?----------?--------?--B-------
-------B-------T--------?---------------?-?-------??-----T------B-----T---------
---------------|-----------------------------------------|------------|---------
m--------------|-----------------------------------------|------T-----|---------
XXXXXXXXXXXXXXX|XXXXXXXXXXXXX--XXXXXXXXXXXXX--XXXXXXXXXXX|XXXXXX|XXXXX|XXXXXXXXX
