------------------------------------------------------------
------------------------------------------------------------
------------------------------------------------------------
------------------------------------------------------------
------------------------------------------------------------
------------------------------------------------------------
-------ooooooooooooooooooooooooooooooooooooooooooo----------
------------B--------------------------M-B--------------v---
--------------------------------------------------------f---
--------------------------------------------------------f---
---------------B----E-----------------B-----------------f---
--------------------------------------------------------f---
--------------------------------------------------------f---
-------------------T------------------------------------f---
m------------------|-------T---T-----T------------------X---
XXXXXXXXXXXXXXXXXXXXXXX--XX|XXX|XXXXX|--XXXXXXX--XXXXXXXXXXX
