--------------------------------------------------------------------------------
--------------------------------------------------------------------------------
--------------------------------------------------------------------------------
--------------------------------------------------------------------------------
--------------------------------------------------------------------------------
--------------------------------------------------------------------------------
-----?-------?-B--------B---?-----B-----B-----?---------------B----B------------
------------?-------------------?-B---------?-------------------------BB----?--v
---------------?-B--B-?-----???-?-B---M---B-----------B--?-----------?----------
----------B---------?-----------------?--?--------------------B---B--?----------
-----?-----B?---B---?-------B--?--------B--?----------------B-?---------B-------
-----------B----B-------?----------B----?------B----------------------------?---
--------B-B---------------------?----?-?B--------?--B?----B---B------B--?-B-----
----------------------------------------------------T------T--------------------
m---------------------------------------------------|------|-----------T--------
XXXXXXXXXXXXXXXXXXXXXXXXXXXXX--XXXXXXXXXXXXXXXXXXXXX|XXXXXX|XXXXXXXXXXX|XXXXXXXX
