------------------------------------------------------------
------------------------------------------------------------
------------------------------------------------------------
------------------------------------------------------------
------------------------------------------------------------
------------------------------------------------------------
------------------------------------------------------------
--------------------------------------------------------v---
---------EE------E-Eo---E--------E----------------------f---
--------------------------------------------------------f---
------------E---E----------------B-B--------------------f---
--------------------------------------------------------f---
--------------------------------------------------------f---
--------------------------------------------------------f---
m-------------------------------------------------------X---
XXXXXXXXXXXXXXXXXXXXXXXXXXXXXXXXXXXXXXXXXXXXXXXXXXXXXXXXXXXX
