------------------------------------------------------------
------------------------------------------------------------
------------------------------------------------------------
------------------------------------------------------------
------------------------------------------------------------
------------------------------------------------------------
------------------------------------------------------------
---------oE------o----------------------------------------v-
-------B--Bo-----------------------E---------------E--------
------------------------------------------------------------
-------?--E---E------------?--?----o-------------EE-E-------
---------?--?-----E--------E------?---?B--?------EXXM-------
--------------?----?-?-----BB---T--B-------?-?---o-----T----
--------------------------------|----------------------|----
m----------------------T-------------------------------|----
XXXXXXXXXXXXXXXXXXXXXXX|XXXXXXXXX--XXXXXXXXXXXXXXXXXXXX|XXXX
