------------------------------------------------------------
------------------------------------------------------------
------------------------------------------------------------
------------------------------------------------------------
------------------------------------------------------------
------------------------------------------------------------
-------ooooooooooooooooooooooooooooooooooooooooooo----------
----------------------E----------E---------o------o-------v-
-----------------------E----------E---------------oEo-------
-------B-------------------E-------------------E--o---------
------------------------------------------------------------
--------------------------------------------------Eo--------
--------B-------------B-------------B-------------X?M--T----
-------------------------------------------------------|----
m--------------------------T---T-----T-----------------|----
XXXXXXXXXXXXXXXXXXXXXXX--XX|XXX|XXXXX|--XXXXXXX--XXXXXX--XXX
