--------------------------------------------------------------------------------
--------------------------------------------------------------------------------
--------------------------------------------------------------------------------
--------------------------------------------------------------------------------
--------------------------------------------------------------------------------
--------------------------------------------------------------------------------
-----------?--B------------B-B----------B------?-----B------------------BB------
----B---------------B--?---------?-------?--?---B------------------------------v
---------------B--MB--M?--------------??------------------------M------?----?---
--------?---------?----B-----??-----??----------------?-?--?-----------?-?------
-----?---------o?----??---M------------?---B-----B--?---?-----------------------
------?---M--------------------B?----B-------------B---------------B--------?---
--------------?----------?-------?----------------------------?---T-------?-----
------------------------------------------------------------------|-------------
m-----------------------------------------------------------------|----T--------
XXXXXXXXXXXXXXXXXXXXXXXXXXXXXXXXXXXXXXXXXXXXXXXXXXXX--XXXXXXXXXXXX|XXXX|XXXXXXXX
