------------------------------------------------------------
------------------------------------------------------------
------------------------------------------------------------
------------------------------------------------------------
o?--X---Xo---M-----------X--------X------------oX-----------
----B----------o-o---|-------M-----M--X--X----?-------------
---------------X-?---oB-XB-------------B---M?---E--?--------
-------------B------E--X-------------?----M-BM-X---------v--
----M---XM--?--------X-----Mo--?--?----B-MX---M----M-----f--
---X---M-X--X-------X-------B-------?M?--o-E--BE---------f--
--?-----?-----?-------X-M-o---M----?--------M--oM--------f--
B---------|-?---?---|M----------EBX--?--M----------------f--
X------------|--|-B-X-MX-----M-MM-E-M-----?--|-XB--------f--
------------------------------------------------------------
m-------------------------------------------------------XXXX
XXXXXXXXXXXXXXXXXXXXXXXXXXXXXXXXXXXXXXXXXXXXXXXXXXXXXXXXXXXX
