--------------------------------------------------------------------------------
--------------------------------------------------------------------------------
--------------------------------------------------------------------------------
--------------------------------------------------------------------------------
--------------------------------------------------------------------------------
--------------------------------------------------------------------------------
-----B------?----?----B--?---B-------------------------------B-B-------?--------
-----------B----B----?-------------?-B-----------B--?--------?B----------B-----v
----M--MBB------------B----?----B----------------?-B----------B----B------?-----
-----------?---B?-----?--BB--------------------B--------?---?B--?-?------B--M---
---------------?-B-----------B----B?----B------------?-----------------B----B---
-----??----------------------------------?B--------B---B-----B-----?---B--------
-------?-------?------B-------B--------?-----------T-------?--B-?--T-B----------
---------------------------------------------------|---------------|------------
m------------------T-------------------------------|---------------|----T-------
XXXXXXXXXXXXXXXXXXX|XXXXXXXXXXXXXXXXXXXXXXXXXXXXXXX|XXX--XXXXXXX--X|XXXX|XXXXXXX
