--------------------------------------------------------------------------------
--------------------------------------------------------------------------------
--------------------------------------------------------------------------------
--------------------------------------------------------------------------------
--------------------------------------------------------------------------------
--------------------------------------------------------------------------------
---------B--------------B-M----------B-------B---?----------------B-----?-------
-------?----B-B--------------?------------------------B-----B-?-------B--------v
-----?-----------------------??----------B----B-?------?------B-----------------
--------B-----B------------?------?--B----------------BB--B---------------------
-----------------B----???B--------------------B-----B-----?--?-?-----B----------
-----------B--------?-B---B--?----------------------------------?---------------
--------?-----------B--------------------?-------------B-B--------------B-------
--------------------------------------------------------------------------------
m--------------------------------------------------------------------------T----
XXXXXXXXXXXXXXXXXXXXXX--XXXXXXXXXXXXXXXXXXXXXXXXXXXXXXXXXXXXXXXXXXXXXXXXXXX|XXXX
