------------------------------------------------------------
------------------------------------------------------------
------------------------------------------------------------
------------------------------------------------------------
o?--X---Xo---M---M----M--X--------X-o----------oXX----------
----B----------o-o---|-------M-----M--X--X----?B------------
-------X-------X-?---oB-XB-------------B---M?---E--?--------
-----M-------B------E--X------------------M-BM-X---------v--
----M---XM--?--------X-----Mo--?--?o---B-MX---M----------f--
---X---M-X--X-------X-B-----B-------?M?--o-E--BE---------f--
--?-----?-----?-------X-M-o-|-M----X--------M--oM--------f--
B---------|-?-X-?X--|M----------EBX--?--M----------------f--
X---------------|-B-X--X-----M-MM-E-M-----?----XB--------f--
------------------------------------------------------------
m-------------------------------------------------------X-XX
XXXXXXXXXXXXXXXXXXXXXXXXXXXXXXXXXXXXXXXXXXXXXXXXXXXXXXXXXXXX
