------------------------------------------------------------
------------------------------------------------------------
------------------------------------------------------------
------------------------------------------------------------
o---X---Xo---M---M-------X--------X------------oXX----------
----B----------o-o---|-------M-----M--X--X---B?B------------
---------------X-?----B-XB-------------B---M?---E--?--------
-------------BM-----E--X------------------M-BM-X---------v--
----M---XM--?--------X------o--?--?----B-MX---M----------f--
---X---M-X--X-------X-------X-------?M?--o-E--BE---------f--
--?-----?-----?-------X-M-o--------?--------M--oM--------f--
B---------|---X-?---|M----------EBX--?--M----------------f--
X------------|--|-B-X--X-----M-MM-E-M-----?--|-XB--------f--
------------------------------------------------------------
m-------------------------------------------------------X-XX
XXXXXXXXXXXXXXXXXXXXXXXXXXXXXXXXXXXXXXXXXXXXXXXXXXXXXXXXXXXX
