------------------------------------------------------------
------------------------------------------------------------
------------------------------------------------------------
------------------------------------------------------------
---|?-E---------XM---X-------|-----?-XoB-X------------------
X--X-M--------X--X-B----X-?B----B------?--?X--X-X-----------
-|X-o-?----------?---o---X---X-----XM--X-EE--E---?-X--------
---X---oX---------------o--X--M--|---------X-BB---X------v--
-?E-X--E--B--?------X------BM--?-----M----------MX-------f--
----B-----?--|-B----M---?BX---M-M----?------------|---------
B------XX-?---o--X--E--||----B--BXB--X--X-------X--------f--
---E-B-MB----|-E--------E----X-------|----X-||B-EB-------f--
---MXM-------M----------M---X--M-XE-----M--------B-------f--
---------------------------------------------------------f--
m-------------------------------------------------------XXXX
XXXXXXXXXXXXXXXXXXXXXXXXXXXXXXXXXXXXXXXXXXXXXXXXXXXXXXXXXXXX
