--------------------------------------------------------------------------------
--------------------------------------------------------------------------------
--------------------------------------------------------------------------------
--------------------------------------------------------------------------------
--------------------------------------------------------------------------------
--------------------------------------------------------------------------------
---------?-B----------B-BB-?---?M-------------?------------B------??------------
--------?-?-?--B-----B--------------------------------?----------B-------------v
-----??--------?----------?-----B-----?-------B-----?-----B-----------B----?----
--------------------------B----B--??-----------??--------B---?--?---------B-----
---------------?-----M----M------------------B-----B---------BB------------??---
-----------?--------------M-----------------?-B----------------B----------B-----
---------------?---?--------?--?---B-----?---?----------B-----------?----B-T----
-----------------------------------------------------------------------T---|----
m-------------------------------------------------T--------------T-----|---|----
XXXXXXXXXXXXXXXXXXXXXXXXXXXXXXXXXXXXXXXXXXXX--XXXX|XXXXXXXXXXXXXX|XXXXX|XXX|XXXX
