------------------------------------------------------------
------------------------------------------------------------
------------------------------------------------------------
------------------------------------------------------------
------------------------------------------------------------
------------------------------------------------------------
------------------------------------------------------------
-------Bo-------------E--------------o------E---o-------v---
--------------------------------------------------------f---
-------ooooooooooooooooooooooooooooooooooooooooooo------f---
--------------------------------------------------------f---
------------B-M-B-E-------------------------------------f---
----------------M---M--------------------M-B------------f---
--------------------------------------------------------f---
m------------------------------------------T-----T------X---
XXXXXXXXXXXXXXXXXX--XXXXXXXXXXXXXXXXXXXXXXX|XXXXX|XXXXXXXXXX
