--------------------------------------------------------------------------------
--------------------------------------------------------------------------------
--------------------------------------------------------------------------------
--------------------------------------------------------------------------------
--------------------------------------------------------------------------------
--------------------------------------------------------------------------------
-----------------------------------?BB----------?---?------------?--------------
-----------------B-----------------------??------B----B----B-----?---B---------v
----------??-M---------------B-B-------?------------------------------------B---
---------?--------------M-?-------------B---------------BB---------M-M----------
------B-----B----------------B-M--------B--------------B----B------B------------
-----------?----B---------------B--------B-----------B--------B--?---------?----
-------B-------------??B--------M-?B-T-----M---?T-B------?----------------------
-------------------------------------|----------|-------------------------------
m------------------------------------|----------|----------------------T--------
XXXXXXXXXXXXXXXXXXXXXXXXXXXXXX--XXXXX|XXXXXX--XX|XXXXXXXXXXXXXXXX--XXXX|XX--XXXX
