------------------------------------------------------------
------------------------------------------------------------
------------------------------------------------------------
------------------------------------------------------------
o?--X---Xo---M---M-------X--------X-o----------oXX----------
----B----------o-o---|-------M-----M--X--X---B?B------------
-------X-------X-?----B-XB-------------B---M?---E--?--------
-------------B------E--X-------------?----M-BM-X---------v--
----M---XM--?--------X-----Mo--?--?----B-MX---M----------f--
---X---M-X--X-------X-------X-------?M?--o-E--BE-X-------f--
--?-----?-----?-------X-M-o-|------?--------M--oM--------f--
B---------|-----?---|M----------EBX--?--M----------------f--
X---------------|-B-X-MX-----M-M--E-M-----?----XB--------f--
------------------------------------------------------------
m-------------------------------------------------------XXXX
XXXXXXXXXXXXXXXXXXXXXXXXXXXXXXXXXXXXXXXXXXXXXXXXXXXXXXXXXXXX
