------------------------------------------------------------
------------------------------------------------------------
------------------------------------------------------------
------------------------------------------------------------
------------------------------------------------------------
------------------------------------------------------------
------------------------------------------------------------
-------B----------o-----------E---o---------------------v---
--------?-E---------o------------------------?----------f---
---------------------------------------------------X----f---
------------E---E----------------B-B--------------------f---
-------B---?-------B--B---E--------------?-B------------f---
-------ooooooooooooooooooooooooooooMoMoooooooooMooX-----f---
---------------------------------------------------T----f---
m---------T----------------------T-----------------|----X---
XXXXXXXXXX|XXXXXXXXXXXXXXX--XXXXX|XXXXXXXXXXXXXXXXX|XXXXXXXX
