--------------------------------------------------------------------------------
--------------------------------------------------------------------------------
--------------------------------------------------------------------------------
--------------------------------------------------------------------------------
--------------------------------------------------------------------------------
--------------------------------------------------------------------------------
--------??----?----?-----B--------------M----------B----B----?------?B----------
---------B----------------------------?--------?---BB-----B--------------------v
------------------------?---o-------------------------------------------B-------
------B--?---??--B-MM-------------------------B----B----------B-----------B-----
----?---?-----------------------------?--------B?---------------------B---------
-------B--------------B------------?------B------B------------------------B-----
----B---B---B---?----------------------?B-------?-------BT------B?--MB----------
-----------------------------------------------------T---|----------------T-----
m------------T---------------------------------------|---|----------------|-----
XXXXXXXXXXXXX|XXXXXXXXXXXXXXXXXXXXXXXXXXXXXXXXXXXXXXX|XXX|XXXXXX--XXXXXXXX--XXXX
