--------------------------------------------------------------------------------
--------------------------------------------------------------------------------
--------------------------------------------------------------------------------
--------------------------------------------------------------------------------
--------------------------------------------------------------------------------
--------------------------------------------------------------------------------
--------B------------?-?-----?--B-B-----?-------?------?-?---------------?------
--------------?---B--B-B--------------------B--?----------?-?---------?--------v
----B--B----?--??-----B---B-------B-----B----B----?M--?---------------?----?----
---------B------B--------------------M----?-?B----BBB--?-------B---?------------
--------------------------------B--------------------?-B-?B----------------B----
---------------M-----?----------------?-----------M------------------------B----
-----?---------B----?-?--B------------------------B---------------B?-?---T------
-------------------------------------------------------------T-----------|------
m------------------------------------------------------------|------T----|------
XXXXXXXXXXXXXXXXX--XXXXXXXXXXXXXXXXXXXXXXXXXXXXXXXX--XXXXXXXX|XXXXXX|XXXX|XXXXXX
