------------------------------------------------------------
------------------------------------------------------------
------------------------------------------------------------
------------------------------------------------------------
------------------------------------------------------------
------------------------------------------------------------
------------------------------------------------------------
---------oE------o----------------------------------------v-
-------B--Bo-----------------------E---------------E--------
------------E---------------------B--E--o--------o----------
-------?--E---E------------?--?----o-------------EE-E-------
---------?--?-----E--------E------?---?B--?------EXXM-------
--------------?----?-?-----BB---T--B-------?-?---o-----T----
----------------T---------------|----------------------|----
m---------------|------T-------------------------------|----
XXXXXXXXXXXXXXXXXXXXXXX|XXXXXXXXX--XXXXXXXXXXXXXXXXXXXX|XXXX
