------------------------------------------------------------
------------------------------------------------------------
------------------------------------------------------------
------------------------------------------------------------
------------------------------------------------------------
------------------------------------------------------------
------------------------------------------------------------
--------------------------------o----E------------E-E---v---
-----------------E------------------ME-------E----EEo---f---
-------------------?----o-----o-----------o-----M---o---f---
------------E-E---E---E---E-----------------?-----------f---
---------??-?-----------o-----?-----------------?--E----f---
---------?--?-----------M------------??---?-------XMX---f---
--------------------------------------------------------f---
m---------T-----------------------T-----------T---T-----X---
XXXXXXXXXX|XXXXXXXXXXXXXXX--XXXXXX|--XXXXXXXXX|XXX|XXXXXXXXX
