--------------------------------------------------------------------------------
--------------------------------------------------------------------------------
--------------------------------------------------------------------------------
--------------------------------------------------------------------------------
--------------------------------------------------------------------------------
--------------------------------------------------------------------------------
--------M--?------B--------M------?--------?-----?---?--------B-----------------
------B--------B----B------------------------B------B----------?------------M--v
----?-B------B------B--------?-----------------BB-------------B-----------------
-----------B?-B--M---B--?-M----------------?---------?------------B----B--B-----
----B--?------M?---------------------------BB--------B-B--B-B---?B-----B--------
--------------------M-----------------?-------?-------?-------?M--B-------------
-----------------B---B--?--?---------??-------M-----------M--T----B-B-----------
-------------------------------------------------------------|-----T------------
m----------T-------------------------------------T-----------|-----|----T-------
XXXXXXXXXXX|XXXXXXXXXXX--XXXXXXXXXXX--XXXXXXXXXXX|XXXXXXXXXXX|XXXXX|XXXX|XXXXXXX
