------------------------------------------------------------
------------------------------------------------------------
------------------------------------------------------------
------------------------------------------------------------
-E------X-XB------E--X---B-----B-X---B--E-BM---BX-----------
----------XX-------B-E--------??-------X----EM--------------
-------X-------X---?--Mo--|B---o--B-------B---|---?---------
--X-----?----o----?---X|--B---X---------E--------X-?-----v--
--o---?-X------B-B-----E?-M-E-----------------B----------f--
M---X-----------MM-?----------?-|X------X-B--------?-----f--
--X--?----M-X----M------?-M?-------B--------B---X--------f--
BX--------------X-B-X---B--------B|o---?-o--?------------f--
--X------X------B--BBB-X----?-?--?----------------o------f--
---------------------------------------------------------f--
m-------------------------------------------------------XXXX
XXXXXXXXXXXXXXXXXXXXXXXXXXXXXXXXXXXXXXXXXXXXXXXXXXXXXXXXXXXX
