--------------------------------------------------------------------------------
--------------------------------------------------------------------------------
--------------------------------------------------------------------------------
--------------------------------------------------------------------------------
--------------------------------------------------------------------------------
--------------------------------------------------------------------------------
----------------?-----?--M------B----------B---------B----?M-----B------B-B-----
-----?-BBB-------B----?-?--?---------B?---M--?-------------------?-----?-------v
-----------------?B----B----------B?-------?-----------------B--------B----?----
---------BM-B--------??-?----?---------?------??---------?B---B----?------------
-------B-----------?-B---B?-------------BB-?--------?---B------------B----------
------B-------?B----?------B-------?--------------------------------------------
----?--------------B--B--------B-------------?----?----B-----TB---B-------B-----
-------------------------------------------------------------|----------T-------
m-----------------------------T------------------------------|----------|-------
XXXXXXXXXXXXXXXXXXXXX--XXXXXXX|XXXX--XXXXXXXXXXXXXXXXXXXXXXXX|XXX--XXXXX|X--XXXX
