--------------------------------------------------------------------------------
--------------------------------------------------------------------------------
--------------------------------------------------------------------------------
--------------------------------------------------------------------------------
--------------------------------------------------------------------------------
--------------------------------------------------------------------------------
-------?--------------------------------B----------------B-----------------B----
----B-----------------------?-------B?---??---?--B-?-M------?----------?-------v
----?----------?----------B---?---------?---------B-------------M---------------
--------------------B---------B?--B--B?------B-------------------------?--------
------------B-----------BBB-------------M---------?-----B---M--B-B--------------
--------B----??--B--B--------------?----------??--?------M--------B---B---------
----?---?------------?-?----M----B---------------?--------BB--------?------?----
--------------------------------------T-----------------------------------------
m-------------------------------------|----------------T------------------T-----
XXXXXXXXXXXXXXXXXXXXXXXXXXXXXXXXX--XXX|XXXXXXXXXXXXXXXX|XXXXXXXXXXXXXXXXXX|XXXXX
