------------------------------------------------------------
------------------------------------------------------------
------------------------------------------------------------
------------------------------------------------------------
o?--X---Xo---M-----------X--------X-o----------oX-----------
----B----------o-o---|-------M-----M--X--X---B?B------------
---------------X-?---oB-XB-------------B---M?---E--?--------
-------------BM-----E--X-------------?----M-BM-X---------v--
----M---XM--?--------X-----Mo--?--?o---B-MX---M----------f--
---X---M-X--X-------X-------B-------?M?--o-E--BE-X-------f--
--?-----?-----?-------X-M-o-|-M----?--------M--oM--------f--
B---------|-?---?---|M----------EBX--?--M----------------f--
X------------|--|-B-X-MX-----M-M--E-M-----?--|-XB--------f--
------------------------------------------------------------
m-------------------------------------------------------XXXX
XXXXXXXXXXXXXXXXXXXXXXXXXXXXXXXXXXXXXXXXXXXXXXXXXXXXXXXXXXXX
