--------------------------------------------------------------------------------
--------------------------------------------------------------------------------
--------------------------------------------------------------------------------
--------------------------------------------------------------------------------
--------------------------------------------------------------------------------
--------------------------------------------------------------------------------
-----B-?---------------B-------------?---B--------------B-----------B-----------
-------------------B---------?--------------------------------------?----------v
----?--?--------------?----------B-----?--M----B---------?--BB------?------B----
-----------?-B--M-----------?---B-?-?------------------???--B------B------------
-----------B---------B-B---------B-------------?-----------------------B--------
------B---------------?B----------?M?--BB-----------------------M----------B----
--------------------------------B----B-?----T--MB-----?-----B?---?-----?--------
--------------------------------------------|-----------------------------------
m--------------------------------T----------|-----------------------------T-----
XXXXXXXXXXXXXXXXXXX--XXXXXXXXXXXX|XXXX--XXXX|XXXXXXXXXXXXXXXXXXXXXX--XXXXX|X--XX
