------------------------------------------------------------
------------------------------------------------------------
------------------------------------------------------------
------------------------------------------------------------
o---X---Xo---M-----------X--------X-o----------oXX----------
---------------o-o---|-------M-----M--X--X----?B------------
-------X-------X-?---oB-XB-------------B---M?---E--?--------
-------------BM-----E--X-------------?----M-BM-X---------v--
----M---XM--?---------------o--?--?o---B-MX---M----------f--
---X---M-X--X-------X-B-----B-------?M?--o-E--BE---------f--
--?-----?-----?-------X-M-o-|------?--------M--oM--------f--
B---------|-?-X-?X--|M----------EBX--?--M---E------------f--
X------------|--|-B-X--X-----M-M--E-M-----?----XB--------f--
------------------------------------------------------------
m-------------------------------------------------------X-XX
XXXXXXXXXXXXXXXXXXXXXXXXXXXXXXXXXXXXXXXXXXXXXXXXXXXXXXXXXXXX
