--------------------------------------------------------------------------------
--------------------------------------------------------------------------------
--------------------------------------------------------------------------------
--------------------------------------------------------------------------------
--------------------------------------------------------------------------------
--------------------------------------------------------------------------------
----------B--------------?-------------B-------------------?--?-----------------
------B-B-------?----B--------------------?-----B--B-B----------?B----BB-------v
----?----?---?----B--------------?B-B----?-------B-----BB-----------------------
----BB--?----B-----------B-----?--------B------?----?------B-----------B-?--B---
-----?-B----?-------------B--B---------B---B--B-----------?----------B--BB?-----
-------------------------------------?---------------B-------M-?B--?------B-----
--------B---B-------B--??B--B------?---------------?-------------------BB-TB----
--------------------------------------------------------------------------|-----
m-------------------------------------------------------T-----------------|-----
XXXXXXXXXXXXXXXXXXXXXXXXXXXXXXXXXXXXXXXXXXXXXXXXXXXXXXXX|XXXXXX--XXXXXXXXX|X--XX
