------------------------------------------------------------
------------------------------------------------------------
------------------------------------------------------------
------------------------------------------------------------
------------------------------------------------------------
------------------------------------------------------------
------------------------------------------------------------
-------MooooooooEoEooooooBooooBooooooooBoooooooEoo------v---
--------------------------------------------------------f---
-------ooooooooooooooooooooooooooooooooooooooooooo-o----f---
--------B--------B--B----------B-o--o-------------XXB---f---
-------ooooMoooooBoBooBooBoooooooooooooooooooooooo------f---
-------BBBBBBBBBBBBBBBBBBBBBBBBBBBBBBBBBBBBBBBBBBB------f---
--------------------------------------------------------f---
m---------T-----------------------T-----------T---T-----X---
XXXXXXXXXX|XXXXXXXXXXXXXXX--XXXXXX|--XXXXXXXXX|XXX|XXXXXXXXX
