--------------------------------------------------------------------------------
--------------------------------------------------------------------------------
--------------------------------------------------------------------------------
--------------------------------------------------------------------------------
--------------------------------------------------------------------------------
--------------------------------------------------------------------------------
-----B-----B--------?---------?---------------------------B----------?M---M-----
---------?----?---------M---?------------------------------------M-------------v
----?----B-----------------B---------B---------?--------------------?-----------
-----------?--------B----B--?------o---?----------------M-------?-?----?--B-----
--------M----------?--------------------BM---------M-------B--------------------
------------B--B--?-------------------------B--B-?-B---------?---------B-?------
-----------B-------B--??----?---B-?-?-----?B?----------B-------T----------------
---------------------------------------------------------------|-----------T----
m----------------------------------T-----T----------------T----|-----------|----
XXXXXXXXXXXXXXXXXXXXXXXXXXXXXXXXXXX|XXX--|XXXXXXXXXXXXXXXX|XXXX--XXXXXXXXXX|XXXX
