------------------------------------------------------------
------------------------------------------------------------
------------------------------------------------------------
------------------------------------------------------------
----------M?X-M---MXM---X---X---X?-------X-XX--X--X---------
X-E---E-?--M-----X-ME------M----o---?-M---------?X----------
--?-------B---------o--?-------X-o-?--X-o-|?----X-----------
-M---?B-o--?------M-B--M------ooBX-X-----?-X-B-----------v--
oX------M-----------X----o-----------o-o-----?---B-------f--
--B|-------X-?o---X-------XB?---X-B--MX--MX-----o?-------f--
?-------?-M---?M--X-o-B------o--X-X----E----------B------f--
-oM--o---oX---B---?--|X-X-M-X---------X-M---X------------f--
B-|?-M---?-----M-oX-B?---?-B-X-----o------------o--------f--
---------------------------------------------------------f--
m-------------------------------------------------------XXXX
XXXXXXXXXXXXXXXXXXXXXXXXXXXXXXXXXXXXXXXXXXXXXXXXXXXXXXXXXXXX
