------------------------------------------------------------
------------------------------------------------------------
------------------------------------------------------------
------------------------------------------------------------
------------------------------------------------------------
------------------------------------------------------------
------------------------------------------------------------
-------B--------E-E------?----?--------o-------E--------v---
--------?-E---------o------------------------?----------f---
-------------E--E------oE--------------o----------EMB---f---
-------oooooEoEoooEoooEoooEoooooooooooooooooBooooo------f---
------------E-------?----E------?---??---------?--------f---
-------ooooooooooooooooooooooooooooMoMoooooooooMooB-----f---
--------------------------------------------------T-----f---
m-------------------------------------------------|-----X---
XXXXXXXXXXXXXXXXXXXXXXXXXXXXXXXXXXXXXXXXXXXXXXXXXX|XXXXXXXXX
