------------------------------------------------------------
------------------------------------------------------------
------------------------------------------------------------
------------------------------------------------------------
--?---E---B------M--?|-|-----?|----??--BX-------------------
---B-M--|-B---B-B-E---X----------?----?B--?-----------------
----X-o-M--?-XM------B---XB----XX--X-----------X-X----------
-------M---E-BE-?------Bo-X-----E|----oE---o----?--------v-v
---X---------X-B-----------------?-----------B--M--B-----f-f
----B-M-----M-X-B---E----B------M?----------X--B-----------f
--o--o-?EX-----------o-|-------------X-----------E-------f-f
---E?--M----M--XB?----B--MMB-X--?-MB----------E?---?-------f
---------M-?-----EX-?-B--------B-----?-----M------?------f-f
---------------------------------------------------------f-f
m-------------------------------------------------------XXXX
XXXXXXXXXXXXXXXXXXXXXXXXXXXXXXXXXXXXXXXXXXXXXXXXXXXXXXXXXXXX
