------------------------------------------------------------
------------------------------------------------------------
------------------------------------------------------------
------------------------------------------------------------
-E------X-XB------E--X---B-----B-X---B--E-BM---BX-----------
----------XX-------B-E--------??------------EM--------------
M------X-------X---?--Mo--|B---o--B-------B---|---?---------
--X-----?----o----?---X|--B---X------X--E--------X-?-----v--
M-o---?-X--------B-----E?-M-?-----------------B----------f--
----X----------?MM-?----------?-|X------X-B--------?-----f--
--X--?------X----M--------M?-------B---M-----------------f--
-X--------------X---X---B--------B|o---?-o--?------------f--
--X------X------B--BBB-X----?----?----------------o------f--
---------------------------------------------------------f--
m-------------------------------------------------------XXXX
XXXXXXXXXXXXXXXXXXXXXXXXXXXXXXXXXXXXXXXXXXXXXXXXXXXXXXXXXXXX
