------------------------------------------------------------
------------------------------------------------------------
------------------------------------------------------------
------------------------------------------------------------
----------M?X-----M-M---X---X---X?-------X-XX--X--X---------
X-E---E-?--M-----X-ME------M----o---?-M---------?X----------
--?-------B---------o--?-------X-o-?--X-o-|?----X-----------
-M---?B-o---------M-B--M------o-BX-X-----?-X-B-----------v--
oX------M-----------X----o-?-?-------o-o-----?---B-------f--
---|-------X--o---X--------B?-----B--MX--MX-----o?-------f--
?-------?-M---?M--X-o-B------o--X-X----E----------B------f--
-oM--o---oX---B---?--|X-X-M-X---------X-M---X----B-------f--
B-|?-----?--B--M-oX-B?---?-B-X-----o------------o--------f--
---------------------------------------------------------f--
m-------------------------------------------------------XXXX
XXXXXXXXXXXXXXXXXXXXXXXXXXXXXXXXXXXXXXXXXXXXXXXXXXXXXXXXXXXX
