--------------------------------------------------------------------------------
--------------------------------------------------------------------------------
--------------------------------------------------------------------------------
--------------------------------------------------------------------------------
--------------------------------------------------------------------------------
--------------------------------------------------------------------------------
------------?-BB-?----------------B-B----B-----?-------------------B---?--------
--------B-------B-----------?-B---?---------------------B--B-----?----B-----?--v
----?------------------------------?B--?-B?--------B--B----------------?--------
--------------?--?B----?B--B---------------B------------B-----------?-----------
-------?B-B----------------------------?---------B----------M-B---------B-------
----B----?-----M------B------M---------------?-----------------B-------B--------
-------------------------B?----?BB?--T------?---------------B-----MT------------
-------------------------------------|-----------------------------|-------T----
m------------------------------------|-----T-------T---------------|-------|----
XXXXXXXXXXXXXXXXXXXXXXXXXXXXXXXXXXXXX|XXXXX|XXXXXXX|XXXXXXX--XXXXXX|XXXXXXX|XXXX
