--------------------------------------------------------------------------------
--------------------------------------------------------------------------------
--------------------------------------------------------------------------------
--------------------------------------------------------------------------------
--------------------------------------------------------------------------------
--------------------------------------------------------------------------------
--------------B-----------B---B-----?-B--------M-B-----------B-B---B-B----------
----B?----B----M---------B---------B------?-M--B---------------?-----?---------v
----------B----------B?-----------B-----------------------------BB-----MB--?----
------------------------------------------B------------B-------M-M------B-------
-----?----B-?-----?------------B------------------------------?------------B----
-------?-------?----B----------B---------------------??--------M?--B----?--?----
------------------B----?-----T----B----?--?----------------M--M--------T--------
-----------------------------|----------------T------------------------|--------
m----------------------------|----------------|------------T-----------|--------
XXXXXXXXXXXXXXXXX--XXXXXXXXXX|X--XXXXXXXXXXXXX|XXXXXXXXXXXX|XXXXXXXX--X|XXXXXXXX
