------------------------------------------------------------
------------------------------------------------------------
------------------------------------------------------------
------------------------------------------------------------
o?--X---Xo---M---M-------X--------X-o----------oX-----------
----B----------o-o---|-------M-----M--X--X----?-------------
---------------X-?---oB-XB-------------B---M?---E--?--------
-------------BM-----E--X-------------?----M-BM-X---------v--
----M---XM--?--------X-----Mo--?--?----B-MX---M----------f--
---X---M-X--X-------X-------B-------?M?--o-E--BE---------f--
--?-----?-----?-------X-M-o-|------?--------M--oM--------f--
B---------|---X-?---|M----------EBX--?--M----------------f--
X---------------|-B-X-MX-----M-MM-E-M-----?--|-XB--------f--
------------------------------------------------------------
m-------------------------------------------------------XXXX
XXXXXXXXXXXXXXXXXXXXXXXXXXXXXXXXXXXXXXXXXXXXXXXXXXXXXXXXXXXX
