------------------------------------------------------------
------------------------------------------------------------
------------------------------------------------------------
------------------------------------------------------------
------------------------------------------------------------
------------------------------------------------------------
------------------------------------------------------------
-------Bo-------------E--------------o------E---o-o-------v-
--------------------------------------------------oEo-------
--------E-----------?-o---------------------o-----o---------
------------------------------------------------------------
--------?-----------------------E-----------------Eo--------
---------------B-----------------B----------B-----X?M--T----
----------T-------------------------T------------------|----
m---------|-------------------------|------T-----T-----|----
XXXXXXXXXXXXXXXXXX--XXXXXXXXXXXXXXXXXXXXXXX|XXXXX|XXXXX--XXX
