--------------------------------------------------------------------------------
--------------------------------------------------------------------------------
--------------------------------------------------------------------------------
--------------------------------------------------------------------------------
--------------------------------------------------------------------------------
--------------------------------------------------------------------------------
----B-----B---M--------?----------------B-----------?B----------M------?-?------
--------B----------------BB-------------------------------------B--------------v
------------------??----?------?------B-------------------B----B----------------
------B---?--?--------------------?--------?------?-------------------B---------
---------------------?----M--?-B---M--B-------B---------M--------?------B--?----
-------M---?----B------M-?-----B-----------?--B-?B-----?---------------B--------
------B-B---------T-----?-----BB----B------------------------------???-T--------
------------------|----------------------------------------------------|--------
m-----------------|------------------------------T---------------T-----|--------
XXXXXXXXXXXXXXXXXX|XXXXXXXXX--XXXXXXXXXXXXXXXXXXX|XXX--XXXXXXXXXX|XXXXX|XXXXXXXX
