------------------------------------------------------------
------------------------------------------------------------
------------------------------------------------------------
------------------------------------------------------------
o---X---Xo---M---M----M--X--------X------------oXX----------
----B----------o-o---|-------M-----M--X--X----?B------------
-------X-------X-?----B-XB-------------B---M?---E--?--------
-------------B------E--X-------------?----M-BM-X---------v--
----M---XM--?--------X-----Mo--?--?o---B-MX---M----------f--
---X---M-X--X-------X-------B-------?M?--o-E--BE-X-------f--
--?-----?-----?-------X-M-o-|------?--------M--oM--------f--
B---------|-?-X-?---|M----------EBX--?--M---E------------f--
X---------------|-B-X--X-----M-MM-E-M-----?--|-XB--------f--
------------------------------------------------------------
m-------------------------------------------------------XXXX
XXXXXXXXXXXXXXXXXXXXXXXXXXXXXXXXXXXXXXXXXXXXXXXXXXXXXXXXXXXX
