------------------------------------------------------------
------------------------------------------------------------
------------------------------------------------------------
------------------------------------------------------------
------------------------------------------------------------
------------------------------------------------------------
------------------------------------------------------------
-------Bo-------------E--------------o------E---o---------v-
-------M------E------------------------B---------E----------
-------B-------------------E-------------------E---EB-------
------------------------------------------------------------
-----------E--o-----?E-------B-B?--------B----E---XM--------
---------------B-----------------B----------B--------T------
-----------------------------------------------------|------
m-----------T-----------------T----T-----------T-----|------
XXXXXXXXXXXX|XXXX--XXXXXXXXXXX|XXXX|XXXXXXXXXXX|XXXXX|XXXXXX
