------------------------------------------------------------
------------------------------------------------------------
------------------------------------------------------------
------------------------------------------------------------
---o--?M-E---BB-X----E--------E-----------------------------
---E--------|-E-B-----X---?-----B-X-XMXB-X-B-M--X-----------
----------X-----------X--?---X-----X------B-X--oM-----------
-M--------------------X-X-XM------?-XE-----XB-B--MX------v--
-?--X----------B----B---o-----------XM--M---------B|-----f--
--|-B--------E--B---XM-------o--M----?-M----X-|M-E-------f--
---|----M--------X-----B|----X---X------B?----M-X-----------
---EMB----BX-|-X--------EM-B-X?----B----B-X------X----------
-----M-?---?------X-------o-E--M----?---M-----X----------f--
---------------------------------------------------------f--
m-------------------------------------------------------XXXX
XXXXXXXXXXXXXXXXXXXXXXXXXXXXXXXXXXXXXXXXXXXXXXXXXXXXXXXXXXXX
