--------------------------------------------------------------------------------
--------------------------------------------------------------------------------
--------------------------------------------------------------------------------
--------------------------------------------------------------------------------
--------------------------------------------------------------------------------
--------------------------------------------------------------------------------
------B-B--B---B---B------?B-------------B-B------------B--------B--------------
----?-------------------------------------------------------B-----?B-----------v
-----B-------------B----------B--B------B-------------?------?------?-----------
-----------?-B-------------B--------B-B----------------------------?-B----B-B---
-------------------------B-----------BB----B-B-----------------?-B--B-----------
--------?---------B-----B-----------B-------B----B-----------------?-------B?---
------?---------M-B--------------------------------?B?------?BB----------B------
-------------------------------------T----T------------------T------------------
m------------------------------------|----|------------------|-----T----T-------
XXXXXXXXXXXXXXXXXXXXXXX--XXXXXXXXXXXX|XXXX|XXXXX--XXXXXXXXXXX|X--XX|XXXX|XXXXXXX
