--------------------------------------------------------------------------------
--------------------------------------------------------------------------------
--------------------------------------------------------------------------------
--------------------------------------------------------------------------------
--------------------------------------------------------------------------------
--------------------------------------------------------------------------------
-------B------B---------?--MB?-----?---B-----B--------------------------B---?---
----M---?------B----------B?-B?-------------?-----?----?----?------?----?B-----v
------B------------?-----?-------------------B-----------------?-----?----------
--------B-----M------?------B-B--------?---B---B---------?-?--------B-----------
-----B---?------?-------BB-------B---?B--B------------------------------B-------
---------?---M-?------------------o---B---?------B--------B-----------------?---
-----B------B---B-----------------B-----B-----B--------??----------T-----TM-----
-------------------------------------------------T-----------------|-----|------
m-------------------------------------------T----|-----------------|-----|------
XXXXXXXXXXXXXXXXXXXXXXXXXXXXXXXXXXXXXXXXXXXX|XXXX|XXXXXXXXXXXXXXXXX|XXXXX|XXXXXX
