------------------------------------------------------------
------------------------------------------------------------
------------------------------------------------------------
------------------------------------------------------------
------------------------------------------------------------
------------------------------------------------------------
------------------------------------------------------------
--------------------------------------B----------E------v---
----------o--------o--------------------E---------------f---
---------------------------------------------------X----f---
--------------------------------------------------------f---
--------?B------------M-------?------------B---M--------f---
-------oooooooooooooooooooooooooooooooooooooooooooX-----f---
---------------------------------------------------T----f---
m---------T----------------------T-----------------|----X---
XXXXXXXXXX|XXXXXXXXXXXXXXX--XXXXX|XXXXXXXXXXXXXXXXX|XXXXXXXX
