------------------------------------------------------------
------------------------------------------------------------
------------------------------------------------------------
------------------------------------------------------------
------------------------------------------------------------
------------------------------------------------------------
------------------------------------------------------------
-------?-----------------------?o------------E------------v-
--------------------------------------------------E?M-------
--------E-----------?-o---------------------o-----?---------
------------------------------------------------------------
--------?-----------------------E---------------------------
---------------B-----------------B----------B---------------
---------------------------------------------------T--------
m--------------------------------------------------|--------
XXXXXXXXXXXXXXXXXXXXXXXXXXXXXXXXXXXXXXXX--XXXXXXXXX|XXXX--XX
