------------------------------------------------------------
------------------------------------------------------------
------------------------------------------------------------
------------------------------------------------------------
------------------------------------------------------------
------------------------------------------------------------
-------MMMMMMMMMMMMMMMMMMMMMMMMMMMMMMMMMMMMMMMMMMM----------
-------MMMMMMMMMMMMMMMMMMMMMMMMMMMMMMMMMMMMMMMMMMM--------v-
-------MMMMMMMMMMMMMMMMMMMMMMMMMMMMMMMMEMMMMMMMMME----------
-------MMMMMMMMMMMMEMMMEMEMMMMMMMMMMMMMMMMMMMMMMME----------
-------MMMMMMMMMMEMMMMMMMMMMMMEMMMMMMMEMMMMMMMMMMMXM--------
-------MMMMMMMMMMMMMMMMMMMMMMMMMMMMMMMMMMMMMMMMMMM----------
-------MMMMMMMMMMMMMMMMMMMMMMMMMMMMMMMMMMMMMMMMMMT----------
-------------------------------------------------|-----T----
m---------T-------T----------------------------T-------|----
XXXXXXXXXX|XXXXXXX|XXXXXXXXXXXX--XXXXXXXX--XXXX|XXXXXXX|XXXX
