------------------------------------------------------------
------------------------------------------------------------
------------------------------------------------------------
------------------------------------------------------------
----------M?X-----MX----X---XX--X?-------X-XX--X--X---------
X-E---E-?--M-----X-ME--M---M----o---?-M---------?X----------
--?-------B---------o--?-------X-o-?--XXo-|?----X-----------
-M---?--o---------M-X--M------o-BX-X-----?-X-B---M-------v--
oX------M-----------X----o-?---------o-o-----?---B-------f--
--B|-------X------X-------XB?---X-B--MX--MX-----o?-------f--
?-------?-M---?M--X-o-B------o--X-X----E----------B------f--
-oM--o---oX---B---?--|X-X-M-X---------X-M---X----B-------f--
B-|?-M---------M-oX-B?---?-B-X-----o------------o--------f--
---------------------------------------------------------f--
m-------------------------------------------------------XXXX
XXXXXXXXXXXXXXXXXXXXXXXXXXXXXXXXXXXXXXXXXXXXXXXXXXXXXXXXXXXX
