------------------------------------------------------------
------------------------------------------------------------
------------------------------------------------------------
------------------------------------------------------------
----X-----M?X-----M-M---X---X---X?-------X-XX--X--X---------
X-E---E-?--M-----X-ME--M---M----o---?-M---------?XB---------
--?-------B---------o--?-------X---?--X---|?----X-----------
-M---?B-o---------M-X--M------o-BX-X-----?-X-B-----------v--
oX------M-----------X----o-?-?-------o-o-----?---B-------f--
--B|-------X-?----X-------XB?---X-B--MX--M------o?-------f--
?---------M---?M--X-o-B------o--X-X----E----------B------f--
-oM--o---oX---B---?--|X-X-M-X---------X-M---X----B-------f--
B-|?-M---------M-oX-B?---?-B-X-----o------------o--------f--
---------------------------------------------------------f--
m-------------------------------------------------------XXXX
XXXXXXXXXXXXXXXXXXXXXXXXXXXXXXXXXXXXXXXXXXXXXXXXXXXXXXXXXXXX
