------------------------------------------------------------
------------------------------------------------------------
------------------------------------------------------------
------------------------------------------------------------
o?--X---Xo---M---M-------X--------X------------oX-----------
----B----------o-o---|-------M-----M--X--X---B?B------------
---------------X-?---oB-XB-------------B---M?---E--?--------
-------------BM-----E--X-------------?----M-BM-X---------v--
----M---XM--?--------------Mo--?--?----B-MX---M----------f--
---X---M-X--X-------X-------X-------?M?--o-E--BE---------f--
--?-----?-----?-------X-M-o-|-M----?--------M--oM--------f--
B---------|---X-?X--|M----------EBX--?--M----------------f--
X---------------|-B-X--X-----M-M--E-M-----?----XB--------f--
------------------------------------------------------------
m-------------------------------------------------------XXXX
XXXXXXXXXXXXXXXXXXXXXXXXXXXXXXXXXXXXXXXXXXXXXXXXXXXXXXXXXXXX
