--------------------------------------------------------------------------------
--------------------------------------------------------------------------------
--------------------------------------------------------------------------------
--------------------------------------------------------------------------------
--------------------------------------------------------------------------------
--------------------------------------------------------------------------------
--------B-------------------------?B--B---B---------??-B-------------?----------
--------M---?B-------B-?----------------B--------------------------------------v
-----------??----M----------B---------B--B----------B--------------?------------
----------B-----------------B----------------------B?-----B---------------------
----------------B--B-----B--------------B--?----------B---B--M---?---?--B---?---
----?-------B----B--B--------B------B---B-----B-----?--------B-------B----------
------B----?--?--------------------?--------M----------B??---------T--------?---
-------------------------------------------------------------------|-------T----
m------------------------------------------------------------------|-------|----
XXXXXXXXXXXXXXXXXXXXXXXXXXXXXXXX--XXXXXXXXXXXXXXXXXXXXXXXXXXXXXXXXX|XXXXXXX|XXXX
