------------------------------------------------------------
------------------------------------------------------------
------------------------------------------------------------
------------------------------------------------------------
-E------X-XB------E------B-----B-X---B--E-BM---BX-----------
----------XX-------B-E--------??-------X----EMX-------------
M------X-------X---?--MoB-|B---o--B-----------|---?---------
--X-----?----o----?---X|--B---X---------E--------X-?-----v--
M-oE--?-X--------B-----E?-M-E-----------------B----------f--
----------------MM|?----------?-|X------X-B--------?-----f--
--X--?----M-X----M------?-M?-------B------------X--------f--
-X-------------BX-B-X---B--------B|o---?-o--?------------f--
--X------X------B--BBB-X----?-?--?----------------o------f--
---------------------------------------------------------f--
m-------------------------------------------------------XXXX
XXXXXXXXXXXXXXXXXXXXXXXXXXXXXXXXXXXXXXXXXXXXXXXXXXXXXXXXXXXX
