------------------------------------------------------------
------------------------------------------------------------
------------------------------------------------------------
------------------------------------------------------------
------------------------------------------------------------
------------------------------------------------------------
-------MMMMMMMMMMMMMMMMMMMMMMMMMMMMMMMMMMMMMMMMMMM----------
-------MMMMMMMMMMMMMMMMMMMMMMMMMMMMMMMMMMMMMMMMMMM--------v-
-------MMMMMMMMMMMMMMMEMMMMMMMMMMMEMMMMMMMMMMMEMMM----------
-------MMMMMMMMMMMMEMMMEMEMMMMMMMMMMMMMMMMMMMMMMME----------
-------MMMMMMMMMMEMMMMMMMMMMMMEMMMMMMMEMMMMMMMMMMMXM--------
-------MMMMMMMMMMMMMMMMMMMMMMMMMMMMMMMMMMMMMMMMMMM----------
-------MMMMMMMMMMMMMMMMMMMMMMMMMMMMMMMMMMMMMMMMMMo----------
-------------------------------------------------------T----
m--------------T---------------T-----------------T-----|----
XXXXXXXXXXXXXXX|XXXXXXXXXXXXXXX|XXXXXXXXXXXXX--XX|XXXXX|XXXX
