------------------------------------------------------------
------------------------------------------------------------
------------------------------------------------------------
------------------------------------------------------------
------------------------------------------------------------
------------------------------------------------------------
------------------------------------------------------------
-------B--------E-E------?----?--------o-------E--E-B---v---
---------EE------E-Eo---E--------E----------------------f---
--------------------------------------------------------f---
--------------------------------------------------oE----f---
--------?B------------M-------?------------B---M--XM----f---
---------?--?-----------M------------??---?-------------f---
--------------------------------------------------------f---
m---------T-----------------------T-----------T-----T---X---
XXXXXXXXXX|XXXXXXXXXXXXXXX--XXXXXX|--XXXXXXXXX|XXXXX|--XXXXX
