------------------------------------------------------------
------------------------------------------------------------
------------------------------------------------------------
------------------------------------------------------------
------------------------------------------------------------
------------------------------------------------------------
------------------------------------------------------------
-------B--------E-E------?----?--------o-------E--------v---
--------?-E---------o------------------------?----------f---
-------------E--E------oE--------------o----------EMB---f---
-------oooooEoEoooEoooEoooEoooooooooooooooooBooooo------f---
------------E-------?----E------?---??---------?--------f---
--------------------------------------------------B-----f---
--------------------------------------------------T-----f---
m------------------------------------------------T|-----X---
XXXXXXXXXXXXXXXXXXXXXXXXXXXXXXXXXXX--XXXXXXXXXXXX||XXXXXXXXX
