--------------------------------------------------------------------------------
--------------------------------------------------------------------------------
--------------------------------------------------------------------------------
--------------------------------------------------------------------------------
--------------------------------------------------------------------------------
--------------------------------------------------------------------------------
-------?-----------------?-B---------?------?--BB----?---B-------B--------------
----------------??M-??--------?---------------B------MB--?---------------------v
-----------B-----B------B---------B----B-----B--------------B-------------------
-------?------B----?------------------B-----------B---------M-----B-M-----------
-------------B---B----M-------??M---------------?-----------?-----B---?---------
------B-B-------B-------B?--B-----B------?-----------B----?B-B---?-?-?----------
-------------------?--?----------B-B---?-----??-B----?B-----------?-B-----------
---------------------------------------------------------------------T----------
m--------------------------------------------------------------------|----T-----
XXXXXXXXXXXXXXXXXXXXXXXXXXXXXXXXXXXXXXXXXXXXXXXXXXXXXXXXXXXX--XXXXXXX--XXX|XXXXX
