--------------------------------------------------------------------------------
--------------------------------------------------------------------------------
--------------------------------------------------------------------------------
--------------------------------------------------------------------------------
--------------------------------------------------------------------------------
--------------------------------------------------------------------------------
----B-----------B---?--------B-------------------B---?BB?-----B?----?-----------
----M----B-B----------B----B--------------B-----------B--------B---B-----------v
-----------------BB-B------?------------B--------------B-----??------M----------
----------B----------------------B--B---------------B--?--------------------M---
-----?--B-------------------B---------B-B-?-------------??---------?------------
---------B-B-BB-----?------B-----B------------B----??--?--?--B---------B-M------
--------B--------B-------?-----------B---------?--------------?---M-------------
----------------------------T----------------------------T--------------T-------
m---------------------------|----------------------------|--------------|-------
XXXXXXXXXXXXXXXXXXXXXXXXXXXX|XXXXXXXXXXXXXXXXXXXXX--XXXXX|X--XXXXXXXXX--|XXXXXXX
