------------------------------------------------------------
------------------------------------------------------------
------------------------------------------------------------
------------------------------------------------------------
------------------------------------------------------------
------------------------------------------------------------
-------ooooooooooooooooooooooooooooooooooooooooooo----------
-------?--------------------------?--------B------------v---
--------------------------------------------------------f---
--------------------------------------------------------f---
--------------------o------E---B------------E-----------f---
------------?-B-?-E-------------------------------------f---
--------------------------------------------------------f---
-------------------------------T------------------------f---
m------------------------------|-----------T-----T------X---
XXXXXXXXXXXXXXXXXX--XXXXXXXXXXXXXXXXXXXXXXX|XXXXX|XXXXXXXXXX
