------------------------------------------------------------
------------------------------------------------------------
------------------------------------------------------------
------------------------------------------------------------
------------------------------------------------------------
------------------------------------------------------------
-------ooooooooooooooooooooooooooooooooooooooooooo----------
------------B--------------------------M-B----------------v-
-------oooEooooooooooooooMooooooooEoooooEoEooooooo----------
------------------------------------------------------------
-------------oo--E--------------------E------E--------------
--------------------------------------------------EE--------
--------------------------------------------------MMM-T-----
-------------------------------T----------------------|-----
m--------------------------T---T-----T----------------|-----
XXXXXXXXXXXXXXXXXXXXXXX--XX|XXX|XXXXX|--XXXXXXX--XXXXX|XXXXX
