------------------------------------------------------------
------------------------------------------------------------
------------------------------------------------------------
------------------------------------------------------------
------------------------------------------------------------
------------------------------------------------------------
------------------------------------------------------------
-------?--------------------------?--------B------------v---
--------------------------------------------------------f---
--------E-----------?-o---------------------o-----------f---
--------------------o------E---B------------E-----------f---
------------?-B-?-E-------------------------------------f---
--------B-?---?------?---?-----?-B---------?-B----------f---
----------T-------------------------T-------------------f---
m---------|---T--------------T------|--T----------------X---
XXXXXXXXXXXXXX|XXXX--XXXXXXXX|XXXXXXXXX|XXXXXXX--XXXXXXXXXXX
