--------------------------------------------------------------------------------
--------------------------------------------------------------------------------
--------------------------------------------------------------------------------
--------------------------------------------------------------------------------
--------------------------------------------------------------------------------
--------------------------------------------------------------------------------
---------?-----B--------------?----------B-B?-----?----------B--B-B-------------
-----B---?-B------------------?----??-------------B------B------------M-M-?----v
--------------?----B----BB----------B-----M----?------------------B--B-----?----
-----?--------B----------------------M-----------------------B-----B------------
-----?------------B---------------BB-?--------?---------------------------------
-----B----B---B---------------B--B-------B--??----------?--------B--------------
--------?---B--B---?---B-?-----B--??---------?---?------------------------------
----------------------------------------------------------------T-----T---------
m--------------------------------T------------------------T-----|-----|---------
XXXXXXXXXXXXXXXXXXX--XXXXXXXXXXXX|XXXXXXXXXXXXXXXXXXXXXXXX|XXXXX|XXXXX|XXXXXXXXX
