--------------------------------------------------------------------------------
--------------------------------------------------------------------------------
--------------------------------------------------------------------------------
--------------------------------------------------------------------------------
--------------------------------------------------------------------------------
--------------------------------------------------------------------------------
----------?----?--------?----B--?-----?--------?------?------BM--------B--------
------B?B---------?----------------------------?-?--?-------------?M-?---------v
---------B-------------B------------------------------M--B-----?----B--B--------
----B---------------BB-----M-------???-------------------?----------------?-----
---------------------------------B-----------------B--------B-------------B-----
--------------???---------------------------------?----B-------------B----------
-----B--------M--------------------B-------------?---------------T--M-------?---
------------T----------------------------------------------------|--------------
m-----------|----------------------------------------------------|---------T----
XXXXXXXXXXXX|XXXXXXXXXXXXXXXXXXXXXXXXXXXXXXXXXXXXXXXX--XXXXXXXXXX|XXXXXXXXX|XXXX
