--------------------------------------------------------------------------------
--------------------------------------------------------------------------------
--------------------------------------------------------------------------------
--------------------------------------------------------------------------------
--------------------------------------------------------------------------------
--------------------------------------------------------------------------------
-------------------------?---?-------------B--?---B?B------------B--B-----------
----BB------B----?-B-------B--?----------?-?-M---------B-M---------------------v
----?--------B----B----?----------------------?--------M------?--B------?-------
--------------??----?-----B-?---B--------------?B------------?---?---?----------
-----------B-------------------?------?-----------?-B---------?-----------------
-----------------------------------------------B------B-------------------------
---------------------?-B-------------M------B---B-----B---------TB--?-?---------
----------------------------------T-----------------------------|----------T----
m--------------------T------------|-----------------------T-----|----T-----|----
XXXXXXXXXXXXXXXXXXXXX|XXXXXX--XXXX|XXXXX--XXXXXXXXXXXXXXXX|XXXXX|XXXX|XXXXX|XXXX
