--------------------------------------------------------------------------------
--------------------------------------------------------------------------------
--------------------------------------------------------------------------------
--------------------------------------------------------------------------------
--------------------------------------------------------------------------------
--------------------------------------------------------------------------------
----B-----?-?-?--?---B---?--------?--B--?--------B-----------------------?-?----
-------------------?---------?----------B--?-------?B------?-?-------BB----?---v
------?-----?-?---?---B-----------------------------B--------?-----M----B-------
----------------------------------B--B--?------------------?--------------------
-------------------------------------B-B--B-??----BB------?---------------------
----------------?----?---------B------------B----B----B----------------?-?--?---
-------------?----------B----------------------?-------?---B---?-----------B----
---------------------------T-----------------------------------------------T----
m--------------------------|-----------------------------------------------|----
XXXXXXXXXXXXXXXXXXXXXXXXX--|XXXXXXXXXXXXXXXXXXXXXXXXXXXXXXXXXXXXXXXXXXXXXXX|XXXX
