------------------------------------------------------------
------------------------------------------------------------
------------------------------------------------------------
------------------------------------------------------------
------------------------------------------------------------
------------------------------------------------------------
------------------------------------------------------------
-------BoooooooooooooooooooooooBBooooooooooooEoooo--------v-
--------------------------------------------------E?M-------
-------ooooooooooooooooooooooooooooooooooooooooooo?---------
------------------------------------------------------------
------------------------------------------------------------
-------ooooooooMoooooooooooooooooMooooooooooMooooo----------
-------------------------------T-------------------T--------
m-------------T--------------T-|-------T-----------|--------
XXXXXXXXXXXXXX|XXXX--XXXXXXXX|XXXXXXXXX|XXXXXXX--XX|XXXX--XX
