------------------------------------------------------------
------------------------------------------------------------
------------------------------------------------------------
------------------------------------------------------------
------------------------------------------------------------
------------------------------------------------------------
------------------------------------------------------------
-------?--------------------------?--------B------------v---
--------------------------------------------------------f---
------------MB-----------E----------------E-------------f---
-------B--o---------------E---------------E----?--------f---
------------?-B-?-E-------------------------------------f---
----------------M---M--------------------M-B------------f---
----------T-------------------------T-------------------f---
m---------|---T---------------------|-------------------X---
XXXXXXXXXXXXXX|XXXXXXXXXXXXXXXXX--XXXXXXXXXXX--XXXXXXXXXXXXX
