--------------------------------------------------------------------------------
--------------------------------------------------------------------------------
--------------------------------------------------------------------------------
--------------------------------------------------------------------------------
--------------------------------------------------------------------------------
--------------------------------------------------------------------------------
------------?-----?-----------M-------------?------B-?---------------?----------
-----?----?B-------------------B-------B----?-------B-------?-M-----?---B------v
--------------B----------??-----B?B-------B------B-?----------------------------
--------------------B--------?--B---------?------?---B----?B--------------------
----B-B--B---B?-B--B--------B---------------?-------?---------B------------B----
-----------?----B--B-------------------B-----?B---------B----------------B------
------------?-------------?----?-----?------------?-B---B----B----B--BBT----?---
----------------------------------------------------------------T------|--------
m---------------------------------------------------------------|------|--------
XXXXXXXXXXXXXXXXXXXXXXXXXXXXXXXXXXXXXXXX--XXXXXXXXXXXXXXXXXXXXXX|XXXXXX|XXXXXXXX
