------------------------------------------------------------
------------------------------------------------------------
------------------------------------------------------------
------------------------------------------------------------
------------------------------------------------------------
------------------------------------------------------------
------------------------------------------------------------
-------B----------o-----------E---o---------------------v---
-----------------------o-------E------------------------f---
--------------------------------------------------------f---
-------oBooooooooooooBoooooooooooooooooooooooooooo------f---
--------?B------------M-------?------------B---M--------f---
-------ooooooooooooooooooooooooooooooooooooooooooo------f---
--------------------------------------------------------f---
m---------T-----------------------T-----------T---------X---
XXXXXXXXXX|XXXXXXXXXXXXXXX--XXXXXX|--XXXXXXXXX|XXXXXXXXXXXXX
