--------------------------------------------------------------------------------
--------------------------------------------------------------------------------
--------------------------------------------------------------------------------
--------------------------------------------------------------------------------
--------------------------------------------------------------------------------
--------------------------------------------------------------------------------
------?-B-B--------B------------B-B--------?----?---------------?----X--?-------
-------------B----------?----M-----------------?--?------------------------B---v
-------?--?-----------------B---B----?B------------------M-----B-B----?----?----
----------?----B------?--------B--B-----B-----B----?----------------------------
-------------------?-----------B--?------------------B----?M---o-----------B----
----?-----?----------?------------B------M-----------------?---------------B----
--------------------B-----B------M----B-------M--B---?------?B-------------T----
------------------------------------------------------------------T--------|----
m-----------------------------------------------------------------|--------|----
XXXXXXXXXXXXXXXXXXXX--XXXXXXXXXXXXXXXXXXXX--XXXXXXXXXXXXXXXXXXXX--|XXXXXXXX|XXXX
