------------------------------------------------------------
------------------------------------------------------------
------------------------------------------------------------
------------------------------------------------------------
------------------------------------------------------------
------------------------------------------------------------
------------------------------------------------------------
-------MooooooooEoEooooooBooooBooooooooBoooooooEoo------v---
-------------o--o-----------------------o----o----------f---
-------ooooooooooooooooooooooooooooooooooooooooooo------f---
------------E---E----------------B-B--------------------f---
--------------------------------------------------------f---
-------ooBooBoooooooooooBooooooooooooBBoooBooooooo------f---
--------------------------------------------------------f---
m---------T---------------------------------------------X---
XXXXXXXXXX|XXXXXXXXXXXXXXXXXXXXXXXXXXXX--XXXXXX--XXXXXXXXXXX
