------------------------------------------------------------
------------------------------------------------------------
------------------------------------------------------------
------------------------------------------------------------
------------------------------------------------------------
------------------------------------------------------------
-------ooooooooooooooooooooooooooooooooooooooooooo----------
-------oooooooEooooBoooooooooBoooooooooooooooooooo------v---
-------ooooooooooooooooooooooooooooooooooooooooooo------f---
--------------------------------------------------------f---
-------oBoooooooooooooMoooooooooooooooBooooooooooo------f---
-------oooooEooooooooooEBoooooooEoooooooooBooooooo------f---
--------------------------------------------------------f---
--------------------------------------------------------f---
m-------------------------------------------------------X---
XXXXXXXXXXXXXXXXXXXXXXXXXXXXXXXXXXXXXXXXXXXXXXXXXXXXXXXXXXXX
