------------------------------------------------------------
------------------------------------------------------------
------------------------------------------------------------
------------------------------------------------------------
o---X---Xo---M-----------X--------X-o----------oX-----------
---------------o-o---|-------------M--X--X---B?B------------
--X----X-------X-?----B-XB---?---------B---M?---E--?--------
-------------B------E--X-------------?----M-BM-X---------v--
----M---XM--?--------X-----Mo--?--?o---B-MX---M----------f--
---X---M-X--Xo------X-------B-------?M?--o-E--BE-X-------f--
--?-----?-----?-------X-M-o-|-M----?--------M--oM--------f--
B---------|-?-X-?---|M----------EBX--?--M---E------------f--
X------------|--|-B-X-MX-----M-M--E-M-----?--|-XB--------f--
------------------------------------------------------------
m-------------------------------------------------------XXXX
XXXXXXXXXXXXXXXXXXXXXXXXXXXXXXXXXXXXXXXXXXXXXXXXXXXXXXXXXXXX
