--------------------------------------------------------------------------------
--------------------------------------------------------------------------------
--------------------------------------------------------------------------------
--------------------------------------------------------------------------------
--------------------------------------------------------------------------------
--------------------------------------------------------------------------------
------------B-B----B---------B-?-B----M-------?----B---------M----B-------------
---------?BB--------------B-----B----B-------B----?---B--------?---?M-?--------v
------??------------o------?---M----?--B--------?--------B----B----BB-----------
------------B-------------------B--?----------------------------------------M---
--------------?--BB-------------------------B--------------?-----B-B--B---------
----B--------?--------------B---?B-----------------------------?-?---B----------
-------B--B----B-B------------------B-------?-?--B-----------?------------------
-------------------------------------------------------------------T-------T----
m------------------------------------------------------------------|-------|----
XXXXXXXXXXXXXXXXXXXXXXXXXXXXXXXXXXX--XXXXXXXXXXXXXXXXXX--XXXXXXXXXX|XXXXXXX|XXXX
