------------------------------------------------------------
------------------------------------------------------------
------------------------------------------------------------
------------------------------------------------------------
------------------------------------------------------------
------------------------------------------------------------
------------------------------------------------------------
-------BoooooooooooooooooooooooooooooooEoooooEoooo------v---
--------------------------------------------------------f---
-------BMMBBBBBBBBBBBBBBBBEBBBEBBBBBBBBBBBBBEBBBBB-o----f---
--------B--------B--B----------B-o--o-------------XXB---f---
--------?B------------M-------?------------B---M--------f---
-------ooooooooooooooooooooooooooooooooooooooooooo------f---
--------------------------------------------------------f---
m---------T----------------------T----------------T-----X---
XXXXXXXXXX|XXXXXXXXXXXXXXX--XXXXX|XXXXXXXXXXXXXXXX|XXXXXXXXX
