--------------------------------------------------------------------------------
--------------------------------------------------------------------------------
--------------------------------------------------------------------------------
--------------------------------------------------------------------------------
--------------------------------------------------------------------------------
--------------------------------------------------------------------------------
-------??---??--B?-----?---BM---B-B----------B------B?-----------B--------------
-----?-?--------------------------------------------?-------B-----B------------v
-----------B-------------B--B-----?------B-B--M--B-------------?------?---------
-----------------------------------?---B?---------------?-------B---?------?----
-----?--B---B-----M--------B-?M--?--M---?-----B?----?-------???---B-------------
----B-----?-------B------M--?---?-----BB-----B-----B----?----------B---?--------
---------------------------T--B-o----?----------------M---------?-----------?---
---------------------------|------T------------------------------------T--------
m--------------------------|------|-------------------------------T----|--------
XXXXXXXXXXXXXXXXXXXXXXXXXXX|XXXXXX|XXXXXXXXXX--XXXXXXXX--XXXXXXX--|XXXX|XXXX--XX
