------------------------------------------------------------
------------------------------------------------------------
------------------------------------------------------------
------------------------------------------------------------
---o--?X-?------X----|-----XM?-----??BX--X-BX-B--B----------
--MXB-----B--XB-BXX---E---?B--------X----X?X---M------------
-|-MM?oXX----M---?B--X---X----?X-----o-----------?----------
------?-XX---E----X-----X-o?--M-EM--?----B-MoB-----------v-v
-oE-XX--------M--B---------XM--M--------X----Bo-MX-------f-f
-----------EM--------------------------------Mo----------f-f
-----B?XB-B------X?--------?-B--BX--------------X--------f-f
--M--B---------E------M------X----------------B?---------f-f
---X-M--M--?--------------o-X-BM-X--------?-X----B-------f-f
---------------------------------------------------------f-f
m-------------------------------------------------------XX-X
XXXXXXXXXXXXXXXXXXXXXXXXXXXXXXXXXXXXXXXXXXXXXXXXXXXXXXXXXXXX
