------------------------------------------------------------
------------------------------------------------------------
------------------------------------------------------------
------------------------------------------------------------
------------------------------------------------------------
------------------------------------------------------------
------------------------------------------------------------
-------B--------E-E------?----?--------o-------E--------v---
--------------------------------------------------------f---
--------------------------------------------------------f---
--------B--------B--B----------B-o--o-------------------f---
--------------------------------------------------------f---
-------ooBooBoooooooooooBooooooooooooBBoooBooooooo------f---
--------------------------------------------------------f---
m-------------------------------------------------------X---
XXXXXXXXXXXXXXXXXXXXXXXXXXXXXXXXXXXXXXXXXXXXXXXXXXXXXXXXXXXX
