--------------------------------------------------------------------------------
--------------------------------------------------------------------------------
--------------------------------------------------------------------------------
--------------------------------------------------------------------------------
--------------------------------------------------------------------------------
--------------------------------------------------------------------------------
----------B?--------?----?B--------B----BM?-----B-------?---M--MB----B----------
-----B-------B?B----B-B------?BB----?----?--?-----B-B----------------o----?----v
-----B-----B-------B--B------------------------------------BB-----M---??--------
--------B----------?-----------------------B--------------?-------?--------B----
----------B-M------------B---------B---?------------B-------?--B-B--?--??-------
----------------------------B----M-------------------------------------B---B----
----B------?------MM----B--------?-------------?------------------?-------------
----------------------------------------------------------------------T---------
m--------------------------------------------------------------T------|---------
XXXXXXXXXXXXXXXXXXXXXX--XXXXXXXXXXXXXXXXXXXXXXXXXXXXXXXXXXXXXXX|XXXXXX|XXXXXXXXX
