------------------------------------------------------------
------------------------------------------------------------
------------------------------------------------------------
------------------------------------------------------------
------------------------------------------------------------
------------------------------------------------------------
------------------------------------------------------------
-------B--------E-E------?----?--------o-------E--------v---
-------------o--o-----------------------o----o----------f---
--------------------E---------------------o-------EMB---f---
-------oooooEoEoooEoooEoooEoooooooooooooooooBooooo------f---
---------B---------?----------------o-------E----o------f---
-------oooooooooooooooooooooooooooooooooooooooooooB-----f---
--------------------------------------------------T-----f---
m------------------------------------------------T|-----X---
XXXXXXXXXXXXXXXXXXXXXXXXXXXXXXXXXXX--XXXXXXXXXXXX||XXXXXXXXX
