--------------------------------------------------------------------------------
--------------------------------------------------------------------------------
--------------------------------------------------------------------------------
--------------------------------------------------------------------------------
--------------------------------------------------------------------------------
--------------------------------------------------------------------------------
----B---B-?-----?----------------B---------?-------------------B-------BBB------
----B-B--B---------B--------?--B------------?-----------------B----------------v
-------------------B?B?------B-----B----?-----------------B----?------------?---
---------B-B--------B----?-B------------------B--------B-------B--------?-------
--------?-?----B------M---------B---??----?-------------M-------B---?B-?--------
--------?---------B--------------------------------M-------------?--B-------?---
-------------------------------B-B----B--?---------------------------T-----B----
----------------------------------------------T----------------------|----------
m---------------------------------------------|----------------------|----------
XXXXXXXXXXXXXXXXXXXXXXXXXXXXXXXXXXXXXXXXXXXXXX|XXXXXXXXXXXXXXXX--XXXX|XXXXXXXXXX
