------------------------------------------------------------
------------------------------------------------------------
------------------------------------------------------------
------------------------------------------------------------
------------------------------------------------------------
------------------------------------------------------------
------------------------------------------------------------
--------?--------------E--E----------------------E--E-----v-
---------o-------------------------------o------------------
---------------------------------------------------EE-------
-------B-o-------?-o------E-------------------E---XB?-------
---------?----E-------------------?-------------------------
--------?---------B----B---------B?--??B--------------T-----
------------------------------------------------------|-----
m---------------------------------T-------------------|-----
XXXXXXXXXXXXXXXXXXXXXXXXXX--XXXXXX|XXXXX--XXXXXXXXXXXX|X--XX
