------------------------------------------------------------
------------------------------------------------------------
------------------------------------------------------------
------------------------------------------------------------
------------------------------------------------------------
------------------------------------------------------------
------------------------------------------------------------
---------o-------?----------------------------------------v-
-------------------B---------------------------o------------
----------------------------------E---------------EE--------
-----------o-----------------------?------------------------
--------?--------E-----B----------------o---------o---------
-----------?-M---?----?--------------B---M?-------BMT-------
--------T-------------------------------------------|-------
m-------|----------T--------------T---T------T------|-------
XXXXXXXXXXXXXXXXXXX|XXXXXXXX--XXXX|XXX|XXXXXX|XXXXXX|XXXXXXX
