------------------------------------------------------------
------------------------------------------------------------
------------------------------------------------------------
------------------------------------------------------------
o?--X---Xo---M---M-------X--------X------------oX-----------
----B----------o-o---|-------M-----M--X--X---B?B------------
-------X-------X-?---oB-XB-------------B---M?---E--?--------
-------------B------E--X-------------?----M-BM-X---------v--
----M---XM--?------o-X-----Mo--?--?o---B-MX---M----M-----f--
---X---M-X--X-------X-B-----B-------?M?--o-E--BE---------f--
--?-----?-----?-------X-M-o-|-M----?--------M--oM--------f--
B---------|-----?X--|M----------EBX--?--M----------------f--
X------------|--|-B-X--X-----M-M--E-M-----?----XB--------f--
------------------------------------------------------------
m-------------------------------------------------------XXXX
XXXXXXXXXXXXXXXXXXXXXXXXXXXXXXXXXXXXXXXXXXXXXXXXXXXXXXXXXXXX
