------------------------------------------------------------
------------------------------------------------------------
------------------------------------------------------------
------------------------------------------------------------
----------M?X-----MXM---X---X---X?-------X-XX--X--X---------
X-E---E-?--M-----X-ME------M----o---?-M---------?XB---------
--?-------B---------o--?-------X---?--X-o-|?----X-----------
-M---?--o--?------M-B--M------o-BX-X-----?-X-B-----------v--
oX------M-----------X----o-?---------o-o-----?---B-------f--
--B|-------X-?o---X-------XB?---X-B--MX--MX-----o?-------f--
?-------?-M---?M--X-o--------o--X-X----E----------B------f--
-oM--o---oX---B---?--|X-X-M-X-----------M---X----B-------f--
B-|?-M---?-----M-oX-B?---?-B-X-----o------------o--------f--
---------------------------------------------------------f--
m-------------------------------------------------------XXXX
XXXXXXXXXXXXXXXXXXXXXXXXXXXXXXXXXXXXXXXXXXXXXXXXXXXXXXXXXXXX
