--------------------------------------------------------------------------------
--------------------------------------------------------------------------------
--------------------------------------------------------------------------------
--------------------------------------------------------------------------------
--------------------------------------------------------------------------------
--------------------------------------------------------------------------------
----B--------B--M-?------B-B?---------------------------M-------------?---------
----?---?--?------?---?--?B----------------B----------?--B-----B-----B---B-B---v
------B---?---B-----BB-----------?--?-------------?-B------------?-------B------
--------?-----------B--B----B---------------B-B-??---B----?---BB-B-----M--------
-----------?----?--?------------?-------B--M----------------------M--?----------
---------?---------------B-------M-----------------------B--?---------B-----?---
---------M---B-------------------?-----------------?-------BB---B--T--MBT-------
-------------------------------------------------------------------|----|-------
m------------------------------------------------------------------|----|-------
XXXXXXXXXXXXXXXXXXXXXXXXXXXXXXXXXXXXXXXXXXXXXXX--XXXXXXXXXXXXXXXXXX|XXXX|XXXXXXX
