--------------------------------------------------------------------------------
--------------------------------------------------------------------------------
--------------------------------------------------------------------------------
--------------------------------------------------------------------------------
--------------------------------------------------------------------------------
--------------------------------------------------------------------------------
----------?--B------?-B-B--?-------------B--B--B----------------B---------------
----------B-------B---------------B--B------B---------?-----??--------B----?---v
-------?----------------B---B----------------B------------------?---------------
----?---?---------B------?-------?----B--------------?-----------?--------------
-----B---------------------------------------------------------?----------------
--------------------------B------------------B--------?----BBM--?---?--BB-------
-----?--B-B-MB---B--------------?-B-------M-----B--B---B----B---B--------B-M----
--------------------------------T----------------------T------------------------
m--------T----------------------|----------------------|---------------T--------
XXXXXXXXX|XXXXXXXXXXXXXXXXXXXXXX|XX--XXXXXXXXXXXXXXXXXX|XXXXX--XXXXXXXX|XXXXXXXX
