--------------------------------------------------------------------------------
--------------------------------------------------------------------------------
--------------------------------------------------------------------------------
--------------------------------------------------------------------------------
--------------------------------------------------------------------------------
--------------------------------------------------------------------------------
--------?----B------?-------?--------?-?--?-----?B--------?---------?----?------
--------?-----------B----B-B?-?---------B-----B----B---------B-----------B--?--v
------B--B------?------?B----?-----?-----------M--------------------------------
---------------B--------?---------B-B-B--------------------------------?--------
--------B----------------B--B?-----------------------B?-------------?-----------
-------M-------------B---?--------------B------------B--------BB----B--?----?---
--------?--------------?-----------B-----------------BB--?-------------?----B---
------------------------------------------------------------------T-------------
m-----------------------------------------------------------------|-------T-----
XXXXXXXXXXXXXXXXXXXXXXXXXXXXXXXXXX--XXXXXXXXXXXXXXXXXXXXXXXXXXXXXX|XXXXXXX|XXXXX
