------------------------------------------------------------
------------------------------------------------------------
------------------------------------------------------------
------------------------------------------------------------
------------------------------------------------------------
------------------------------------------------------------
------------------------------------------------------------
-------?-----------------------?o------------E------------v-
------------------------------------------------------------
-----------------------------------o-------------Eo---------
-------------oo--E--------------------E------E----oM--------
------------B-M-B-E-----------------------------------------
----------------M---M--------------------M-B------?---------
---------------------------------------------------T--------
m------------------------------------------T-----T-|--------
XXXXXXXXXXXXXXXXXX--XXXXXXXXXXXXXXXXXXXXXXX|XXXXX|X|XXXXXXXX
