--------------------------------------------------------------------------------
--------------------------------------------------------------------------------
--------------------------------------------------------------------------------
--------------------------------------------------------------------------------
--------------------------------------------------------------------------------
--------------------------------------------------------------------------------
------??---B-?---?--------------------------------------------------------------
-----B------------B--------?-------B--------------B---?B--------?---?-------?--v
------?------B----?---B---B----?----------M-?-B------??--------B----------------
---------------?-------BBB----?-----------------B-----------?-B---B---?-B-------
-------M------oB------------------------?----B-?B---------------?-----B---------
-----?B----B------------------------M-----------B-----------------------?-------
-------------------------M----------------------B--------TB----?--T-------T-----
-------------------------------------------------T-------|--------|-------|-----
m------------------------------------------------|-------|--------|-------|-----
XXXXXXXXXXXXXXXXXXXXXX--XXXXXXXXXXXXXXXXXXXXXXXXX|XXXXXXX|X--XXXXX|XXXXXXX|XXXXX
