------------------------------------------------------------
------------------------------------------------------------
------------------------------------------------------------
------------------------------------------------------------
o---X---Xo---M---M----M--X--------X-o----------oX-----------
---------------o-o---|-------M-----M--X--X----?-------------
-------X-------X-?---oB-XB-------------B---M?---E--?--------
-------------B------E--X------------------M-BM-X---------v--
----M---XM--?--------------Mo--?--?----B-MX---M----------f--
---X---M-X--X-------X-------B-------?M?--o-E--BE---------f--
--?-----?-----?-------X-M-o-|------?--------M--oM--------f--
B---------|-?---?---|M----------EBX--?--M---E------------f--
X------------|--|-B-X--X-----M-M--E-M-----?----XB--------f--
------------------------------------------------------------
m-------------------------------------------------------X-XX
XXXXXXXXXXXXXXXXXXXXXXXXXXXXXXXXXXXXXXXXXXXXXXXXXXXXXXXXXXXX
