------------------------------------------------------------
------------------------------------------------------------
------------------------------------------------------------
------------------------------------------------------------
------------------------------------------------------------
------------------------------------------------------------
------------------------------------------------------------
-------?--------------------------?--------B------EE------v-
------------------------------------------------------------
-------BoooBoooooooooooooooooooooooooooBoooooooBoo----------
-------B--o---------------E---------------E----?------------
------------?-B-?-E-----------------------------------------
--------------------------------------------------XM--------
-------------------------------T---------------T------------
m-------------T----------------|---------------|------------
XXXXXXXXXXXXXX|XXXXXXXXXXXXXXXXX--XXXXXXXXXXX--XXXXXXXXX--XX
