------------------------------------------------------------
------------------------------------------------------------
------------------------------------------------------------
------------------------------------------------------------
----------M?X-----MXM---X---XX--X?-------X-XX--X--X---------
X-E---E-?--M-----X-ME--M---M----o---?-M---------?XB---------
--?-------B---------o--?-------X-o-?--X-o-|?----X-----------
-M---?--o--?------M-B--M------o-BX-X-----?-X-B-----------v--
o-------M-----------X----o-?---------o-o-----?---B-------f--
--B|-------X------X-------XB?---X-B--MX--MX-----o?-------f--
?-------?-----?M--X-o-B------o--X-X----E----------B------f--
-oo--o---oX---B---?--|X-X-M-X---------X-M---X----B-------f--
B-|?-M---------M-oX-B?---?-B-X-----o------------o--------f--
---------------------------------------------------------f--
m-------------------------------------------------------XXXX
XXXXXXXXXXXXXXXXXXXXXXXXXXXXXXXXXXXXXXXXXXXXXXXXXXXXXXXXXXXX
