------------------------------------------------------------
------------------------------------------------------------
------------------------------------------------------------
------------------------------------------------------------
------------------------------------------------------------
------------------------------------------------------------
------------------------------------------------------------
-------B--------E-E------?----?--------o-------E--------v---
--------------------------------------------------------f---
--------------------------------------------------------f---
--------B--------B--B----------B-o--o-------------------f---
-------B---?-------B--B---E--------------?-B------------f---
-------ooBooBoooooooooooBooooooooooooBBoooBooooooo------f---
--------------------------------------------------------f---
m---------T-----------------------T-----------T---------X---
XXXXXXXXXX|XXXXXXXXXXXXXXX--XXXXXX|--XXXXXXXXX|XXXXXXXXXXXXX
