------------------------------------------------------------
------------------------------------------------------------
------------------------------------------------------------
------------------------------------------------------------
------------------------------------------------------------
------------------------------------------------------------
------------------------------------------------------------
-------B----------o-----------E---o---------------------v---
--------------------------------------------------------f---
--------------------------------------------------------f---
------------E---E----------------B-B--------------------f---
-------B---?-------B--B---E--------------?-B------------f---
-------ooooooooooooooooooooooooooooMoMoooooooooMoo------f---
--------------------------------------------------------f---
m---------T-----------------------T-----------T---------X---
XXXXXXXXXX|XXXXXXXXXXXXXXX--XXXXXX|--XXXXXXXXX|XXXXXXXXXXXXX
