------------------------------------------------------------
------------------------------------------------------------
------------------------------------------------------------
------------------------------------------------------------
-X----E-X-----------ME-------?|----|?--BX-----B--XB---------
-----?----B-M-X|B-E---X?---X-----?----?-?--X----------------
-|--X-o-M----X----B--B---------X-----o--X-M----X-?-X--------
------?M-B-E--?--------B-oX-----EM-------B-BoB-----?-----v-v
-?E-X--M-----B-------------oM--M-------------B--o--------f-f
-B--o--?---EM-------EM----------M?----------XM-B--|--------f
-X-|----X------------oX|-----XM-BM------B---M---XE-------f-f
--M----ME---M--XB?----B--MMBXXM-----BX-------ME--Xo--------f
-----------?M-----X---BXM-?-------?-----X----X-----------f-f
---------------------------------------------------------f-f
m-------------------------------------------------------XXXX
XXXXXXXXXXXXXXXXXXXXXXXXXXXXXXXXXXXXXXXXXXXXXXXXXXXXXXXXXXXX
