------------------------------------------------------------
------------------------------------------------------------
------------------------------------------------------------
------------------------------------------------------------
------------------------------------------------------------
------------------------------------------------------------
------------------------------------------------------------
-------B--------E-E------?----?--------o-------E--------v---
--------------------------------------------------------f---
-------ooooooooooooooooooooooooooooooooooooooooooo-o----f---
--------------------------------------------------XXB---f---
-------B---?-------B--B---E--------------?-B------------f---
---------?--?-----------M------------??---?-------------f---
--------------------------------------------------------f---
m---------T-----------------------T-----------T---T-----X---
XXXXXXXXXX|XXXXXXXXXXXXXXX--XXXXXX|--XXXXXXXXX|XXX|XXXXXXXXX
