--------------------------------------------------------------------------------
--------------------------------------------------------------------------------
--------------------------------------------------------------------------------
--------------------------------------------------------------------------------
--------------------------------------------------------------------------------
--------------------------------------------------------------------------------
-------------------B--B-B---BB------?----?-B-------?------?---B-B---------------
----------??---B----?---B--------------------B---------------------B-----------v
-------------------------B-?--B-----M-B-----------------B-?------?----?---------
-----?-----B-------------------B--?------B-----?----------?---------------------
--------------?-B-----B--?---------???--------B--?---------B-?-B---B------------
--------??----------B--------M------B?---------M?--------?B-?----?--?-----B-----
-----------M--------B-------?--------?----B-------------BB-M-?-----B-----T------
-------------------------------------------------------------------------|------
m--------------------------------------------------------------------T---|------
XXXXXXXXXXXXXXXXXXXXXXXXXXX--XXXXXXXXXXXXXXXXXXXXXXXXXXXXXXXXXXXXXXXX|XXX|XXXXXX
