--------------------------------------------------------------------------------
--------------------------------------------------------------------------------
--------------------------------------------------------------------------------
--------------------------------------------------------------------------------
--------------------------------------------------------------------------------
--------------------------------------------------------------------------------
------B----B?---?---?--?B--------B--------------------B-------------------------
----------------?--------------B-----?---B-B---?-----------------?---B----?B---v
------?------------?-----------B--------B-B-----B-----B--M--MB-----?------------
----B-------BB------?-------?-----------------B----------B--------M----?--------
------------B-------?--------B--BB-------------------------?---------M--?-------
--------?-----------------B-?-?-----?-----------?B----?-----BB----B-------?-----
----------B------------------?--------------------------------B-----------------
-------------------------------------------------------------------------T------
m---------------------------------------------------------------T--------|------
XXXXXXXXXXXXXXXXXXXXXX--XXXXXXXXXXXXXXXXXXXXX--XXXXXXXXXX--XXXXX|XXX--XXX|XXXXXX
