------------------------------------------------------------
------------------------------------------------------------
------------------------------------------------------------
------------------------------------------------------------
------------------------------------------------------------
------------------------------------------------------------
------------------------------------------------------------
-------B--------E-E------?----?--------o-------E--------v---
-------------o--o-----------------------o----o----------f---
-------ooooooooooooooooooooooooooooooooooooooooooo------f---
--------------------------------------------------------f---
-------B---?-------B--B---E--------------?-B------------f---
--------------------------------------------------------f---
--------------------------------------------------------f---
m---------T-----------------------T-----------T---------X---
XXXXXXXXXX|XXXXXXXXXXXXXXX--XXXXXX|--XXXXXXXXX|XXXXXXXXXXXXX
