------------------------------------------------------------
------------------------------------------------------------
------------------------------------------------------------
------------------------------------------------------------
------------------------------------------------------------
------------------------------------------------------------
------------------------------------------------------------
-------B--------E-E------?----?--------o-------E--------v---
-----------------------o-------E------------------------f---
-------ooooooooooooooooooooooooooooooooooooooooooo------f---
------------E---E----------------B-B--------------------f---
---------??-?-----------o-----?-----------------?-------f---
---------?--?-----------M------------??---?-------------f---
--------------------------------------------------------f---
m---------T-----------------------T-----------T---------X---
XXXXXXXXXX|XXXXXXXXXXXXXXX--XXXXXX|--XXXXXXXXX|XXXXXXXXXXXXX
