------------------------------------------------------------
------------------------------------------------------------
------------------------------------------------------------
------------------------------------------------------------
-E------X-XB------E------B-----B-X---B--E-BM---BX-----------
----------XX-------B-E--------??-------X--X-EM--------------
-------X-------X---?--MoB-|B---o--B---------B-|---?---------
--X-----?----o----?---X|--B---X---------E--------X-?-----v--
--oE--?-X--------B-----E?-M-E----------------------------f--
M---X----------?MM-?----------?-|X------X-BE-------?-----f--
--X--?------X----M------?-M?-------B--------B---X--------f--
BX--------------X---X---B--------B|o---?-o--?------------f--
--X------X------B--BBB-X--X-?-?--?----------------o------f--
---------------------------------------------------------f--
m-------------------------------------------------------XXXX
XXXXXXXXXXXXXXXXXXXXXXXXXXXXXXXXXXXXXXXXXXXXXXXXXXXXXXXXXXXX
