------------------------------------------------------------
------------------------------------------------------------
------------------------------------------------------------
------------------------------------------------------------
------------------------------------------------------------
------------------------------------------------------------
-------MMMMMMMMMMMMMMMMMMMMMMMMMMMMMMMMMMMMMMMMMMM----------
-------MMMMMMMMMMMMMMMMMMMMMMMMMMMMMMMMMMMMMMMMMMM--------v-
-------MMMMMMMMMMMMMMMMMMMMMMMMMMMMMMMMEMMMMMMMMME----------
-------MMMMMMMMMMMMMMMMMMMMMEMMMMMMMMMMMMMMMMMMMEE----------
-------MMMMMMMMMMMMMMMMMMMMMMMMMMMMMMMMMMMMMEMMMMMXM--------
-------MMMMMMMMMMMMMMMMMMMMMMMMMMMMMMMMMMMMMMMMMMM----------
-------MMMMMMMMMMMMMMMMMMMMMMMMMMMMMMMMMMMMMMMMMMT----------
-------------------------------------------------|-----T----
m--------------T---------------T-----------------T-----|----
XXXXXXXXXXXXXXX|XXXXXXXXXXXXXXX|XXXXXXXXXXXXX--XX|XXXXX|XXXX
