------------------------------------------------------------
------------------------------------------------------------
------------------------------------------------------------
------------------------------------------------------------
------------------------------------------------------------
------------------------------------------------------------
------------------------------------------------------------
-------B-----------------------Bo------------E----------v---
--------------------------------------------------------f---
--------E-----------B-o---------------------o-----------f---
--------------------------------------------------------f---
--------B-----------------------E-----------------------f---
----------------M---M--------------------M-B------------f---
--------------------------------------------------------f---
m-------------T--------------T---------T----------------X---
XXXXXXXXXXXXXX|XXXX--XXXXXXXX|XXXXXXXXX|XXXXXXX--XXXXXXXXXXX
