------------------------------------------------------------
------------------------------------------------------------
------------------------------------------------------------
------------------------------------------------------------
----X-----M?X-----MXM---X---X---X?-------X-XX--X--X---------
X-E---E-?--M-----X-ME------M--?-o---?-M---------?XB---------
--?-------B---------o--?-------X---?--X---|?----X-----------
-M---?B-o---------M-B--M------o-BX-X-----?-X-B-----------v--
oX------M-----------X----o-?---------o-o-----?---B-------f--
--B|-------X------X-------XB?---X-B--MX--MX-----o?-------f--
?---------M---?M--X-o-B------o--X-X----E----------B------f--
-oM--o---oX---B---?--|X-X-M-X---------X-M---X----B-------f--
B-|?-----?-----M-oX-B?---?-B-X-----o------------o--------f--
---------------------------------------------------------f--
m-------------------------------------------------------XXXX
XXXXXXXXXXXXXXXXXXXXXXXXXXXXXXXXXXXXXXXXXXXXXXXXXXXXXXXXXXXX
