--------------------------------------------------------------------------------
--------------------------------------------------------------------------------
--------------------------------------------------------------------------------
--------------------------------------------------------------------------------
--------------------------------------------------------------------------------
--------------------------------------------------------------------------------
-----?---?-----B--------?B-?-------B--B---?----B---B---------?---------B--------
-----B--------------------?-----?-------------------------?----------------B---v
-------?-?---?------------------------?--B---B?B------------------------?--B----
----------?-------B-----B-?----?-------------M----o-------?---?---B-B---?-------
----------B--------B?---------?------B-B-----------------?---B------------------
--------?-----?---------?------------------------------?M--------B?----B--------
----B---------?--?-?------------B----?-M------------B-----------B----?---BT-----
--------------------------------------------------------------------------|-----
m-------------------------------------------------------------------------|-----
XXXXXXXXXXXXXXXX--XXXXXXXXXXXXXXXXXXXXXXXXXXXXXXXXXXXXXXXXXXXXXXXXXXXXXXXX|XXXXX
