--------------------------------------------------------------------------------
--------------------------------------------------------------------------------
--------------------------------------------------------------------------------
--------------------------------------------------------------------------------
--------------------------------------------------------------------------------
--------------------------------------------------------------------------------
----B--?-------?B---B?-------?----------M---------M-------------------------B---
-----------------B----B----?--B----------?-------B--------B---------?------??--v
---------------------?-?-B----?-----B--------?--?----B-----------?-?---B--B-----
---------B-----B-B------------------?B-----?--------?--B-B-------B---B----------
----B------?------------B-------------?-----------------------B-----------------
------B--?----------------------------------------------B---B--B?---?-----------
------------------?--------------------------------B-B-?--------------?B--------
--------------------------------------------------------------------------T-----
m-------------------------------------------------------T-----------------|-----
XXXXXXXXXXXXXXXXXXX--XXXXXXXXX--XXXXXXXXXXXX--XXXXXXXXXX|XX--XXXXXXXXXXXXX|XXXXX
