------------------------------------------------------------
------------------------------------------------------------
------------------------------------------------------------
------------------------------------------------------------
------------------------------------------------------------
------------------------------------------------------------
------------------------------------------------------------
------------------------------------------?-------E-------v-
-------?o----?-------------------------------------EE-------
------------------?-----------------------------------------
---------------o---------o-------E----------?------E?-------
--------E------------B---?-----------?------------MB--------
---------------?-------?-?----------B----?------------------
------------------------------------------------------------
m-------------------T-------T-------------T-----------------
XXXXXXXXXXXXXXXXXXXX|--XXXXX|XXXXXXXXXXXXX|--XXXXXXXXXXXXXXX
