------------------------------------------------------------
------------------------------------------------------------
------------------------------------------------------------
------------------------------------------------------------
------------------------------------------------------------
------------------------------------------------------------
------------------------------------------------------------
-----------------------E-----o--E----E--------o-----------v-
-------oooEooooooooooooooMooooooooEoooooEoEooooooo----------
------------------------------------------------------------
-------------oo--E--------------------E------E--------------
---------B--------B?-------?---------o------------EE--------
------------??----------?-------?----------------BMMM-T-----
-------------------------------T----------------------|-----
m------------------------------|----------------------|-----
XXXXXXXXXXXXXXXXXXXXXXXXXXXXXXXXXXXXXXXX--XXXXXXXXXXXX|XXXXX
