------------------------------------------------------------
------------------------------------------------------------
------------------------------------------------------------
------------------------------------------------------------
------------------------------------------------------------
------------------------------------------------------------
------------------------------------------------------------
-------B--------E-E------?----?--------o-------E--------v---
-----------------E------------------ME-------E----------f---
-------------o-----------------E------M---------??EMB---f---
--------?------------?----------------------------------f---
--------?B------------M-------?------------B---M--------f---
-------oooooooooooooooooooooooooooooooooooooooooooB-----f---
--------------------------------------------------T-----f---
m-------------------------------------------------|-----X---
XXXXXXXXXXXXXXXXXXXXXXX--XXXXXXXXXXXX--XXXXXXX--XX|XXXXXXXXX
