------------------------------------------------------------
------------------------------------------------------------
------------------------------------------------------------
------------------------------------------------------------
------------------------------------------------------------
------------------------------------------------------------
-------ooooooooooooooooooooooooooooooooooooooooooo----------
-------ooooooooooooooooooooooooooooooooooooooooooo------v---
-------ooooooooooooooooEooooooooooEooooooooooooooo------f---
-------oEoooooooooooBoBoooooooooooooooooooooBooooo------f---
-------BMBMBBBBBMBEBBBEBBBBBBBBBBBBBBBBBBBBBBBBBBB------f---
-------ooooooooooooooooooooooooooooooooooooooooooo------f---
-------oBoooooooooooBoooooooooooooBooooooBBooBoooo------f---
--------------------------------------------------------f---
m------------------------------------------T-----T------X---
XXXXXXXXXXXXXXXXXX--XXXXXXXXXXXXXXXXXXXXXXX|XXXXX|XXXXXXXXXX
