------------------------------------------------------------
------------------------------------------------------------
------------------------------------------------------------
------------------------------------------------------------
-E------X-XB------E------B-----B-X---B--E-BM---BX-----------
----------XX-------B-E--------??-------X--X-E-X-------------
-------X-B-----X---?--MoB-|B---o--B---------B-|---?---------
--X-----?----o----?---X|--B---X---------E--------X-?-----v--
--o---?-X------B-B-----E?-M-E----------------------------f--
M---------------MM-?----------?-|X------X-BE-------?-----f--
--X--?------X----M------?-M?-------B---M----B---X--------f--
BX--------------X-B-X---B--------B|o---?-o--?------------f--
--X------X------B--BBB-X----?----?----------------o------f--
---------------------------------------------------------f--
m-------------------------------------------------------XXXX
XXXXXXXXXXXXXXXXXXXXXXXXXXXXXXXXXXXXXXXXXXXXXXXXXXXXXXXXXXXX
