------------------------------------------------------------
------------------------------------------------------------
------------------------------------------------------------
------------------------------------------------------------
o---X---Xo---M---M-------X--------X------------oX-----------
----B----------o-o---|------------?M--X--X----?-------------
-------X-------X-?----B-XB-------------B---M?---E--?--------
-----M-------BM-----E--X-------------?----M-BM-X---------v--
----M---XM--?--------X-----Mo--?--?----B-MX---M----------f--
---X---M-X--X-------X-------B-------?M?--o-E--BE---------f--
--?-----?-----?-------X-M-o---M----?--------M--oM--------f--
B---------|---X-?---|M----------EBX--?--M----------------f--
X---------------|-B-X--X-----M-MM-E-M----------XB--------f--
------------------------------------------------------------
m-------------------------------------------------------XXXX
XXXXXXXXXXXXXXXXXXXXXXXXXXXXXXXXXXXXXXXXXXXXXXXXXXXXXXXXXXXX
