------------------------------------------------------------
------------------------------------------------------------
------------------------------------------------------------
------------------------------------------------------------
------------------------------------------------------------
------------------------------------------------------------
------------------------------------------------------------
-------B--------E-E------?----?--------o-------E--------v---
-------------o--o-----------------------o----o----------f---
-------------E--E------oE--------------o----------------f---
--------------------------------------------------------f---
---------B---------?----------------o-------E----o------f---
-------ooooooooooooooooooooooooooooooooooooooooooo------f---
--------------------------------------------------------f---
m------------------------------------------------T------X---
XXXXXXXXXXXXXXXXXXXXXXXXXXXXXXXXXXX--XXXXXXXXXXXX|XXXXXXXXXX
