------------------------------------------------------------
------------------------------------------------------------
------------------------------------------------------------
------------------------------------------------------------
----------M?X-----MXM---X---X---X?------BX-XX--X--X---------
X-E---E-?--M-----X-ME------M----o---?-M---------?X----------
--?-------B---------o--?-------X-o-?--X---|?----X-----------
-M---?B-o--?------M-X--M------o-BX-X-----?-X-B-----------v--
oX------M-----------X----o-?-?-------o-o---------B-------f--
--B|-------X-?o---X--------B?---X-B--MX--MX-----o?-------f--
?-------?-M---?M--X-o-B------o--X-X----E----------B------f--
-oM--o---oX---B---?--|X-X-M-X---------X-M---X----B-------f--
B-|?-M---?--B--M-oX-B?---?-B-X-----o------------o--------f--
---------------------------------------------------------f--
m-------------------------------------------------------XXXX
XXXXXXXXXXXXXXXXXXXXXXXXXXXXXXXXXXXXXXXXXXXXXXXXXXXXXXXXXXXX
