------------------------------------------------------------
------------------------------------------------------------
------------------------------------------------------------
------------------------------------------------------------
----------M?X-----MXM---X---X---X?-------X-XX--X--X---------
X-E---E-?--M-----X-ME--M---M--?-o---?-M---------?XB---------
--?-------B---------o--?-------X---?--X-o-|?----X-----------
-M---?B-o--?------M-B--M------ooBX-X--?--?-X-B-----------v--
oX------M-----------X----o-?---------o-o-----?---B-------f--
--B|-------X-?----X--------B?---X-B--MX--MX-----o?-------f--
?-------?-M---?M--X-o-B------o--X-X----E----------B------f--
-oM--o---oX---B---?--|X-X-M-X-----------M---X----B-------f--
B-|?-----?-----M-oX-B?---?-B-X-----o------------o--------f--
---------------------------------------------------------f--
m-------------------------------------------------------XXXX
XXXXXXXXXXXXXXXXXXXXXXXXXXXXXXXXXXXXXXXXXXXXXXXXXXXXXXXXXXXX
