------------------------------------------------------------
------------------------------------------------------------
------------------------------------------------------------
------------------------------------------------------------
o---X---Xo---M---M----M--X--------X------------oXX----------
---------------o-o---|-------M-----M--X--X---B?B------------
-------X-------X-?---oB-XB-------------B---M?---E--?--------
-------------BM-----E--X------------------M-BM-X---------v--
----M---XM--?--------X-----M---?--?----B-MX---M----M-----f--
---X---M-X--Xo------X-------B-------?M?--o-E--BE---------f--
--?-----?-----?-------X-M-o-|-M----?--------M--oM--------f--
B---------|-?---?---|M----------EBX--?--M---E------------f--
X------------|--|-B-X--X-----M-MM-E-M-----?--|-XB--------f--
------------------------------------------------------------
m-------------------------------------------------------X-XX
XXXXXXXXXXXXXXXXXXXXXXXXXXXXXXXXXXXXXXXXXXXXXXXXXXXXXXXXXXXX
