--------------------------------------------------------------------------------
--------------------------------------------------------------------------------
--------------------------------------------------------------------------------
--------------------------------------------------------------------------------
--------------------------------------------------------------------------------
--------------------------------------------------------------------------------
-----B-----------------??-----?----------------?B-------------------------------
--------------B--------------?---?---------------------------?-----B------BB---v
-----?-------B-?----------------------?--B------------B-------------------------
-------------?-B-------------?-B--?--?--?----------B--B-------------------------
-----B-------------------------?-?-----------B--?--?------?---B------??--?------
-------?-?--------B-------?------------------?------B------------BM---?---------
------B-----------B----------B-------B-?----B--------?-B-----------------T------
--------------------------------------------------------------T----------|------
m------------------------------------------------T-----T------|----------|------
XXXXXXXXXXXXXXXXXXXXXX--XXXXXXXXXXXXXXXXXXXXXXXXX|XXXXX|XXXXXX|XXXXXXXXXX|XXXXXX
