------------------------------------------------------------
------------------------------------------------------------
------------------------------------------------------------
------------------------------------------------------------
o---X---Xo---M---M----M--X--------X-o----------oX-----------
----B----------o-o---|-------M-----M--X--X----?-------------
-------X-------X-?----B-XB---?---------B---M?---E--?--------
-------------B------E--X------------------M-BM-X---------v--
----M---XM--?--------X-----Mo--?--?o---B-MX---M----M-----f--
---X---M-X--X-------X-B-----B-------?M?--o-E--BE---------f--
--?-----?-----?-------X-M-o-|-M----?--------M--oM--------f--
B---------|-?---?---|M----------EBX--?--M----------------f--
X---------------|-B-X--X-----M-MM-E-M-----?--|-XB--------f--
------------------------------------------------------------
m-------------------------------------------------------XXXX
XXXXXXXXXXXXXXXXXXXXXXXXXXXXXXXXXXXXXXXXXXXXXXXXXXXXXXXXXXXX
