------------------------------------------------------------
------------------------------------------------------------
------------------------------------------------------------
------------------------------------------------------------
--------X-XB------E------B-----B-X---B--E-BM---BX-----------
----------XX-------B-E--------??-------X----EM--------------
-------X-------X---?--MoB-|B---o--B-------B-B-|---?---------
--X----------o----?---X|--B---X---------E--------X-------v--
--o---?-X--------B-----E?-M-?-----------------B----------f--
M---X----------?MM-?----------?-|X------X-B--------?-----f--
--X--?------X----M------?-M?-------B---------------------f--
BX-------------BX-B-X---BM-------B|o---?-o--?------------f--
--X------X------B--BBB-X----?-?--?----------------o------f--
---------------------------------------------------------f--
m-------------------------------------------------------XXXX
XXXXXXXXXXXXXXXXXXXXXXXXXXXXXXXXXXXXXXXXXXXXXXXXXXXXXXXXXXXX
