------------------------------------------------------------
------------------------------------------------------------
------------------------------------------------------------
------------------------------------------------------------
----------M?X-----M-----X---X---X?-------X-XX--X--X---------
X-E---E-?--M-----X-ME--M---M----o---?-M---------?X----------
--?-------B---------o--?-------X---?--XXo-|?----X-----------
-M---?B-o--?------M-B--M------o-BX-X-----?-X-B-----------v--
oX------M-----------X----o-?---------o-o-----?---B-------f--
--B|-------X-?----X--------B?-----B--MX--MX-----o?-------f--
?-------?-M---?M--X-o--------o--X-X----E----------B------f--
-oM--o---oX---B---?--|X-X-M-X---------X-M---X----B-------f--
B-|?-M-----------oX-B?---?-B-X-----o------------o--------f--
---------------------------------------------------------f--
m-------------------------------------------------------XXXX
XXXXXXXXXXXXXXXXXXXXXXXXXXXXXXXXXXXXXXXXXXXXXXXXXXXXXXXXXXXX
