------------------------------------------------------------
------------------------------------------------------------
------------------------------------------------------------
------------------------------------------------------------
------------------------------------------------------------
------------------------------------------------------------
-------MMMMMMMMMMMMMMMMMMMMMMMMMMMMMMMMMMMMMMMMMMM----------
-------MMMMMMMMMMMMMMMMMMMMMMMMMMMMMMMMMMMMMMMMMMMo-E-----v-
-------BBBBBBBBBBBBBBBBBBBBBBBBBBBBBBBBEBBBBBBBBBEX??-------
-------BBBBBBBBBBBBEBBBEBEBBBBBBBBBBBBBBBBBBBBBBBE----------
-------BBBBBBBBBBEBBBBBBBBBBBBEBBBBBBBEBBBBBBBBBBB----------
-------MMMMMMMMMMMMMMMMMMMMMMMMMMMMMMMMMMMMMMMMMMM----------
-------BBBBBBBBBBBBBBBBBBBBBBBBBBBBBBBBBBBBBBBBBBTBBB-------
-------------------------------------------------|-----T----
m--------------T---------------T-----------------T-----|----
XXXXXXXXXXXXXXX|XXXXXXXXXXXXXXX|XXXXXXXXXXXXX--XX|XXXXX|XXXX
