------------------------------------------------------------
------------------------------------------------------------
------------------------------------------------------------
------------------------------------------------------------
------------------------------------------------------------
------------------------------------------------------------
-------ooooooooooooooooooooooooooooooooooooooooooo----------
-------oooooooEooooBoooooooooBoooooooooooooooooooo------v---
-------ooooooooooooooooooooooooooooooooooooooooooo------f---
--------------------------------------------------------f---
-------oooooooooooooBooooooEoooMooooooooooooEooooo------f---
-------oooooEooooooooooEBoooooooEoooooooooBooooooo------f---
------------??----------?-------?----------------B------f---
--------------------------------------------------------f---
m-------------------------------------------------------X---
XXXXXXXXXXXXXXXXXXXXXXXXXXXXXXXXXXXXXXXXXXXXXXXXXXXXXXXXXXXX
