--------------------------------------------------------------------------------
--------------------------------------------------------------------------------
--------------------------------------------------------------------------------
--------------------------------------------------------------------------------
--------------------------------------------------------------------------------
--------------------------------------------------------------------------------
-----?---------?-?---?-------BB-?------?---------------------MB----B------------
------------?--------------B?-?-?-----------B--M-------------?-----B---?-------v
------?----B----------------?-B-?--?---------------?--B-------------------------
----?--------?--?-----------B---------B--------B--------B--?B--------?----B-----
-------------------------B-------MB-------------?--BB-----------M-------BB------
------??--------------------------?---------?---?-------B-B--?--?--------B------
-------------------------B------B-----B-------------B------B-----?MB----MT------
-----------------------------T------------------------------------T------|------
m----------------------------|--------------------------------T---|------|------
XXXXXXXXXXXXXXXXXXXXXXXXXXXXX|XXXXXXXXXXXXXXXXX--XXXXXXXXXX--X|XXX|XXXXXX|--XXXX
