------------------------------------------------------------
------------------------------------------------------------
------------------------------------------------------------
------------------------------------------------------------
------------------------------------------------------------
------------------------------------------------------------
------------------------------------------------------------
--------------------------------------B----------E-oo---v---
--------------------------------------------------------f---
-------ooooooooooooooooooooooooooooooooooooooooooo------f---
--------------------------------------------------ooE---f---
---------?-----------?--??------------------------EEE---f---
---------?--?-----------M------------??---?-------M?B---f---
----------------------------------------------------T---f---
m---------------------------------------------------|---X---
XXXXXXXXXXXXXXXXXXXXXXXXXXXXXXXXXXXXXXXXXXXXXXXXXXXX|XX-XXXX
