--------------------------------------------------------------------------------
--------------------------------------------------------------------------------
--------------------------------------------------------------------------------
--------------------------------------------------------------------------------
--------------------------------------------------------------------------------
--------------------------------------------------------------------------------
--------B------?---------------?-B------B-?-----------?-----?-------------B-----
-----?-B-------------B--?-----BB?--B------------?M----?----?----B--M-----------v
------?--B------?----------B-----?---------------?-----B--------B---------------
----?---------------B--?-------------------------------------?-----B--B---------
--------------------?-----------------B?--------B----B-------?------?----?------
---------B-------------------------?--------------B------------------B----------
------B--?----------------B---------M---------------------------BT--?---T---B---
-----------------------------------------------------------------|------|-------
m----------------------------------------------------------------|------|-------
XXXXXXXXXXXXXXXXXXXXXXXXXXXXXXXXXXXXXXXXXXXXXXXXXXXXXXXXXXXXXXXXX--XXXXX|XXXXXXX
