------------------------------------------------------------
------------------------------------------------------------
------------------------------------------------------------
------------------------------------------------------------
------------------------------------------------------------
------------------------------------------------------------
------------------------------------------------------------
-------MooooooooooBoooooooooooEoooBooooooooooooooo-oo---v---
--------------------------------------------------------f---
-------BMMBBBBBBBBBBBBBBBBEBBBEBBBBBBBBBBBBBEBBBBB------f---
--------B------------B----------------------------ooE---f---
-------ooooMoooooBoBooBooBooooooooooooooooooooooooEEE---f---
-------ooooooooooooooooooooooooooooMoMoooooooooMooM?B---f---
----------------------------------------------------T---f---
m---------------------------------------------------|---X---
XXXXXXXXXXXXXXXXXXXXXXXXXXXXXXXXXXXXXXXXXXXXXXXXXXXX|XX-XXXX
