--------------------------------------------------------------------------------
--------------------------------------------------------------------------------
--------------------------------------------------------------------------------
--------------------------------------------------------------------------------
--------------------------------------------------------------------------------
--------------------------------------------------------------------------------
----?-B----------------BB------?------------B------B--B---?--------B---B-?------
----------------B----B-B-B-------?--------?----B----B----------?-----------B---v
----B-----------?-------------B---BB--B----B--------------B-------------?-------
-------------M-----B-B------------------------------------------?---------------
----B?-M---------?-------M--B--?------------------------B?----------------------
-----------?----------?-----B----------------B-?-----------B--------------------
---------------------?-----------?-------BB---??------B----?------B-------------
-----------------------------T---------------------------------------------T----
m--------------T-------------|---------------------------------------------|----
XXXXXXXXXXXXXXX|X--XXXXXXXXXX|XXXXXXXXXXXXXXXXXXXXXXXXXXXXXXXXXXXXXXXXXXXXX|XXXX
