--------------------------------------------------------------------------------
--------------------------------------------------------------------------------
--------------------------------------------------------------------------------
--------------------------------------------------------------------------------
--------------------------------------------------------------------------------
--------------------------------------------------------------------------------
----?-----B-----?-------BB-----B---------------?--------------B-B-B----?--------
------B?-----B-B------------BB--B------------?B-----?--M---?------?----B-------v
-----B---------B--------------------B-----------------------------???-----?-----
-------------?--------?------??------B-B-----?-B---------B-B------------?-------
------?-?-----?M-??-----?-----B----B-BB--------B---BB-------?-----?---B---------
------B-?--B-B-------------B?----B---M-------B--------------------?-------------
-----?-?----M------------------------------------B---B-??T-----T--B--T----------
---------------------------------------------------------|-----|-----|----------
m--------------------------------------------------------|-----|-----|----------
XXXXXXXXXXXXXXXXXXXXXXX--XXXXXXXXXXXXXXXXXXXXXXXXXXXXXXXX|X--XX|XXXXX|XXXXXXXXXX
