------------------------------------------------------------
------------------------------------------------------------
------------------------------------------------------------
------------------------------------------------------------
----------M?X-----M-----X---XX--X?-------X-XX--X--X---------
X-E---E-?X-M-----X-ME--M---M--?-o---?-M---------?XB---------
--?-------B---------o--?-------X-o-?--XXo-|?----X-----------
-M---?B-o--?------M-B--M------o-BX-X-----?-X-B-----------v--
oX------M-----------X----o-?---------o-o-----?---B-------f--
--B|-------X------X--------B?-----B--MX--M------o?-------f--
?-------?-M---?M--X-o--------o--X-X----E----------B------f--
-oM--o---oX---B---?--|X-X-M-X---------X-M---X----B-------f--
B-|?-M---?-----M-oX-B?---?-B-X-----o------------o--------f--
---------------------------------------------------------f--
m-------------------------------------------------------XXXX
XXXXXXXXXXXXXXXXXXXXXXXXXXXXXXXXXXXXXXXXXXXXXXXXXXXXXXXXXXXX
