------------------------------------------------------------
------------------------------------------------------------
------------------------------------------------------------
------------------------------------------------------------
o---X---Xo---M---M-------X--------X------------oXX----------
----B----------o-o---|-------M-----M--X--X----?B------------
-------X-------X-?---oB-XB-------------B---M?---E--?--------
-------------B------E--X------------------M-BM-X---------v--
----M---XM--?--------X-----Mo--?--?------MX---M----M-----f--
---X---M-X--Xo------X-------X-------?M?--o-E--BE---------f--
--?-----?-----?-------X-M-o-|------?--------M---M--------f--
B---------|---X-?---|M----------EBX--?--M---E------------f--
X------------|--|-B-X-MX-----M-MM-E-M-----?--|-XB--------f--
------------------------------------------------------------
m-------------------------------------------------------X-XX
XXXXXXXXXXXXXXXXXXXXXXXXXXXXXXXXXXXXXXXXXXXXXXXXXXXXXXXXXXXX
