------------------------------------------------------------
------------------------------------------------------------
------------------------------------------------------------
------------------------------------------------------------
o---X---Xo---M--------M--X--------X------------oXX----------
----B---?------o-o---|-------M-----M--X--X---B?-------------
-------X-------X-?----B-XB-------------B---M?---E--?--------
-------------BM-----E--X-------------?----M-BM-X---------v--
----M---XM--?--------X-----Mo--?--?------MX---M----M-----f--
---X---M-X--X-------X-B-----X-------?M?--o-E--BE---------f--
--?-----?-----?-------X-M-o-|------?--------M--oM--------f--
B---------|-?-X-?X--|M----------EBX--?--M---E------------f--
X------------|--|-B-X--X-----M-M--E-M-----?--|-X---------f--
------------------------------------------------------------
m-------------------------------------------------------X-XX
XXXXXXXXXXXXXXXXXXXXXXXXXXXXXXXXXXXXXXXXXXXXXXXXXXXXXXXXXXXX
