--------------------------------------------------------------------------------
--------------------------------------------------------------------------------
--------------------------------------------------------------------------------
--------------------------------------------------------------------------------
--------------------------------------------------------------------------------
--------------------------------------------------------------------------------
-------BB------------B--?--o--?-----B--M---B---?-------------------?------------
-----B-------B------B-----------------?--?---B--------------B------------?-----v
---------?---------B---------B-B------------------------------------------------
-----?-----B---------?----------B---?-?B-B------?B-----------------B-B----------
-----------------?-----------------------B--?--BBB-------B-------------B--------
---------------------------B-?------BB-------B-?----BB-M-------M--?---BB--------
-----?------------?-T-BM-T--------------B------T-----B----B-B-B---?M-T-----BB---
--------------------|----|--------T------------|---------------------|-----T----
m-------------------|----|--------|------------|--------------T------|-----|----
XXXXXXXXXXXXXXXXXXXX|XXXX|XXXXXXXX|XXXXXXXXXXXX|XXXXXXXXXXX--X|XXXXXX--XXXX|XXXX
