------------------------------------------------------------
------------------------------------------------------------
------------------------------------------------------------
------------------------------------------------------------
------------------------------------------------------------
------------------------------------------------------------
------------------------------------------------------------
-------B--------E-E------?----?--------o-------E--------v---
--------------------------------------------------------f---
-------ooooooooooooooooooooooooooooooooooooooooooo------f---
--------------------------------------------------------f---
--------?B------------M-------?------------B---M--------f---
---------?--?-----------M------------??---?-------------f---
--------------------------------------------------------f---
m-------------------------------------------------------X---
XXXXXXXXXXXXXXXXXXXXXXXXXXXXXXXXXXXXXXXXXXXXXXXXXXXXXXXXXXXX
