------------------------------------------------------------
------------------------------------------------------------
------------------------------------------------------------
------------------------------------------------------------
----------M?X-----M-M---X---X---X?------BX-XX--X--X---------
X-E---E-?--M-----X-ME--M---M----o---?-M---------?XB---------
--?-------B---------o--?-------X-o-?--X---|?----X-----------
-M---?--o--?------M-B--M------o-BX-X-----?-X-B-----------v--
o-------M-----------X----o-?---------o-o-----?---B-------f--
--B|-------X------X-------XB?-----B--MX--MX-----o?-------f--
?-------?-M---?M--X-o-B------o--X-X----E----------B------f--
-oM--o---oX---B---?--|X-X-M-X---------X-M---X----B-------f--
B-|?-M---?-----M-oX-B?---?-B-X-----o------------o--------f--
---------------------------------------------------------f--
m-------------------------------------------------------XXXX
XXXXXXXXXXXXXXXXXXXXXXXXXXXXXXXXXXXXXXXXXXXXXXXXXXXXXXXXXXXX
