--------------------------------------------------------------------------------
--------------------------------------------------------------------------------
--------------------------------------------------------------------------------
--------------------------------------------------------------------------------
--------------------------------------------------------------------------------
--------------------------------------------------------------------------------
---------?----?--------BM-------B-----------------?-------B---------B-----------
----B?MB----?------------B----B--------------?-?--?----B-----------?-B---?-----v
------------------------------------??-?--------------------B--B--???--M--B-----
--------?M-B-B--B----?--?------------------------------B-----------B------------
------------------------B---B-M---B--B------?------------------B-----?----------
------?---------?-----------?-B-?----B--------?-------------B--B----------------
-----B-M--B------B-----B-?B-?B-?-----B-----B----B-------TM---?-----?------------
--------------------------------------------T-----T-----|------------T----------
m-------------------------------------------|-----|-----|------------|-----T----
XXXXXXXXXXXXXXXXXXXXXXXXXXXXXXXXXXXXX--XXXXX|XXXXX|XXXXX|XXXXXXXXXXXX|XXXXX|XXXX
