------------------------------------------------------------
------------------------------------------------------------
------------------------------------------------------------
------------------------------------------------------------
o?--X---Xo---M--------M--X--------X-o----------oX-----------
----B---?------o-o---|-------M-----M--X--X---B?B------------
---------------X-?----B-XB-------------B---M?---E--?--------
-------------BM-----E--X-------------?----M-BM-X---------v--
----M---XM--?--------------Mo--?--?o---B-MX---M----M-----f--
---X---M-X--X-------X-B-----B-------?M?--o-E--BE---------f--
--?-----?-----?-------X-M-o-|------?--------M--oM--------f--
B---------|-?-X-?---|M----------EBX--?--M---E------------f--
X------------|--|-B-X--X-----M-M--E-M-----?----XB--------f--
------------------------------------------------------------
m-------------------------------------------------------X-XX
XXXXXXXXXXXXXXXXXXXXXXXXXXXXXXXXXXXXXXXXXXXXXXXXXXXXXXXXXXXX
