--------------------------------------------------------------------------------
--------------------------------------------------------------------------------
--------------------------------------------------------------------------------
--------------------------------------------------------------------------------
--------------------------------------------------------------------------------
--------------------------------------------------------------------------------
-------------------?----?---B-?--??--------------?B---?-------B---B?------------
----------------------------------M------??--?----------------?----------------v
---------?-BB-----?----------?M--------------------?----------------------------
-----?----B-?------------------B--B-----?-----------------?---B----------B------
-------?-----------BB------------------M--------B-----------------B-------------
---------------------------------------M-M--------------------------------------
-------?-B--------B----------?--------------B------?--B-----B-?-----------------
-----------------------------------------------------------T--------------------
m----------------------------------------------------------|----------T---------
XXXXXXXXXXXXXXXXXXXXXXXXXXXXXXXXXXXXXXXXXXXXXXXXXXX--XXXXXX|XXXXXXXXXX|XXXXXXXXX
