------------------------------------------------------------
------------------------------------------------------------
------------------------------------------------------------
------------------------------------------------------------
---|--?--?-X-B---B?-B------X--------X----o------B-B---------
E--BXX--B-------------X-B---Xo---------?-XX---XMX-----------
------?-X----M-----X-o----MB-X-----X---X---oX-?X-?----------
-------M---?-------M--E-o-X---M--|?B--M----X----X-?------v--
-?-----E-----------B-----------?------------------X------f--
B---o-M-----M---------X|---?----------XM------|----------f--
-X-|-o-X?X?o-----X-----BX--?B---B------------?---EM------f--
-X------E----|------E-B--M---X-B-X?B---------|E--B-------f--
-----MB--M---M----B-?---E-o-X----?--?------M--X----------f--
---------------------------------------------------------f--
m-------------------------------------------------------XX-X
XXXXXXXXXXXXXXXXXXXXXXXXXXXXXXXXXXXXXXXXXXXXXXXXXXXXXXXXXXXX
