------------------------------------------------------------
------------------------------------------------------------
------------------------------------------------------------
------------------------------------------------------------
------------------------------------------------------------
------------------------------------------------------------
------------------------------------------------------------
-------?-----------------------?o------------E------------v-
--------------------------------------------------E?M-------
------------MB-----------E----------------E-------?---------
------------------------------------------------------------
------------B-M-B-E-----------------------------------------
------------??----------?-------?----------------B----------
---------------------------------------------------T--------
m--------------------------------------------------|--------
XXXXXXXXXXXXXXXXXXXXXXXXXXXXXXXXXXXXXXXX--XXXXXXXXX|XXXX--XX
