--------------------------------------------------------------------------------
--------------------------------------------------------------------------------
--------------------------------------------------------------------------------
--------------------------------------------------------------------------------
--------------------------------------------------------------------------------
--------------------------------------------------------------------------------
----B?-------B-------M--------------------?-------------B--B----?---------------
-----------B--?--?-----------------?----------------?---?-B--------------------v
-----B-------------------------?B--B----?----------?-------------?--------------
-----B-----?---------?-----------------------------------?----?---------B---o---
---------B--?-----?---------------?---B----------------------------?B------?----
-------?--M-----------------B-----?----------------------?----------------------
----B--------------------B------------------M-B---------B----?-?---------B------
----------------------------------------------------------------------T---------
m---------------------------------------------------------------------|---------
XXXXXXXXXXXXXXXXXXXXXXXXXXXXXXXXXXXXXXXXXXXXXXXXXXXXXXXXXXXXXXXXXXX--X|XXXXX--XX
