------------------------------------------------------------
------------------------------------------------------------
------------------------------------------------------------
------------------------------------------------------------
o---X---Xo---M---M-------X--------X------------oXX----------
---------------o-o---|-------M-----M--X--X---B?B------------
---------------X-?---oB-XB-------------B---M?---E--?--------
-------------BM-----E--X------------------M-BM-X---------v--
----M---XM--?--------X-----M---?--?----B-MX---M----M-----f--
---X---M-X--X-------X-B-----B-------?M?--o-E--BE---------f--
--?-----?-----?-------X-M-o-|------?--------M--oM--------f--
B---------|-----?X--|M----------EBX--?--M---E------------f--
X---------------|-B-X--X-----M-MM-E-M-----?--|-XB--------f--
------------------------------------------------------------
m-------------------------------------------------------XXXX
XXXXXXXXXXXXXXXXXXXXXXXXXXXXXXXXXXXXXXXXXXXXXXXXXXXXXXXXXXXX
