------------------------------------------------------------
------------------------------------------------------------
------------------------------------------------------------
------------------------------------------------------------
-E------X-XB------E------B-----B-X---B--E-BM---BX-----------
----------XX-------B-E--------??-------X--X-EMX-------------
-------X-------X---?--MoB-|B---o--B-----------|---?---------
--X-----?----o----?---X|--B---X---------E--------X-?-----v--
--o---?-X--------B-----E?-M-E-----------------B----------f--
M---X-----------MM-?----------?-|X------X-B--------?-----f--
--X--?----M-X----M------?-M?----B--B------------X--------f--
BX-------------BX---X---B--------B|o---?-o--?------------f--
--X------X------B--BBB-X--X-?-?--?----------------o------f--
---------------------------------------------------------f--
m-------------------------------------------------------XXXX
XXXXXXXXXXXXXXXXXXXXXXXXXXXXXXXXXXXXXXXXXXXXXXXXXXXXXXXXXXXX
