------------------------------------------------------------
------------------------------------------------------------
------------------------------------------------------------
------------------------------------------------------------
------------------------------------------------------------
------------------------------------------------------------
-------ooooooooooooooooooooooooooooooooooooooooooo----------
-------Bo-------------E--------------o------E---o-------v---
--------------------------------------------------------f---
--------E-----------?-o---------------------o-----------f---
--------------------o------E---B------------E-----------f---
--------?-----------------------E-----------------------f---
---------------B-----------------B----------B-----------f---
--------------------------------------------------------f---
m------------------------------------------T-----T------X---
XXXXXXXXXXXXXXXXXX--XXXXXXXXXXXXXXXXXXXXXXX|XXXXX|XXXXXXXXXX
