------------------------------------------------------------
------------------------------------------------------------
------------------------------------------------------------
------------------------------------------------------------
------------------------------------------------------------
------------------------------------------------------------
-------ooooooooooooooooooooooooooooooooooooooooooo----------
--------------------------------------------------------v---
-----------------------E----------E---------------------f---
-------ooooooooooooooooEoooooooooooooooBoooooooooo------f---
--------------------------------------------------------f---
--------------------------------------------------------f---
--------B-------------B-------------B-------------------f---
--------------------------------------------------------f---
m--------------------------T---T-----T------------------X---
XXXXXXXXXXXXXXXXXXXXXXX--XX|XXX|XXXXX|--XXXXXXX--XXXXXXXXXXX
