------------------------------------------------------------
------------------------------------------------------------
------------------------------------------------------------
------------------------------------------------------------
-X-----X-----X-------E-------?-----??-----BX-----XB---------
----B?----B?M-X|X-E-----X--B----------?---?-----------------
-|--X|o---M--X-E--BX-oX---M--X?-M---------M-X--X------------
-------M-X---B--?--|--EB?--XX----B-------B-X|------?-----v-v
-?EM-X----B--B----o-----|--o-?-?-------------------------f-f
----oX-?---EM-X-----EM---B-----XM?---?------XMXB-----------f
-X------E---------?--o-|X-----B--MB--E--B-------XE-------f-f
---E---MB------X------B--MX-XX?----BB--------ME--Xo------f-f
--MM-----M--MM--XEX--EB---?-X----X?-?---X----------------f-f
---------------------------------------------------------f-f
m-------------------------------------------------------XXXX
XXXXXXXXXXXXXXXXXXXXXXXXXXXXXXXXXXXXXXXXXXXXXXXXXXXXXXXXXXXX
