--------------------------------------------------------------------------------
--------------------------------------------------------------------------------
--------------------------------------------------------------------------------
--------------------------------------------------------------------------------
--------------------------------------------------------------------------------
--------------------------------------------------------------------------------
--------?-----------------?----------B-----B------------B?------------?---B-B---
----B---------------------?B------------B?--?------------------B-----?---------v
-----B------??-------------BB-----B--------------------------------------?------
----B----------B-BB------?----?---------------BBB------------?----B---BB--------
------B-----------------B-----------------B----?-----------------?--B--?--------
--------------?------B--------B--?---------------------B?---?-----?-M-----------
----------------------T------B--?--------------------?-?--------M---?-----------
---------T------------|-----T---------------------------------------T-----------
m--------|-----T------|-----|---------------------------------------|------T----
XXXXXXXXX|XXXXX|XXXXXX|XXXXX|XXXXXXXXXXXXXXXXXXXXXXXXXXX--XXXXXXXXXX|--XXXX|XXXX
