--------------------------------------------------------------------------------
--------------------------------------------------------------------------------
--------------------------------------------------------------------------------
--------------------------------------------------------------------------------
--------------------------------------------------------------------------------
--------------------------------------------------------------------------------
----?----?------------------B-B------?-?-------?------?-------------------M-----
------------------------?------B---B-----------------B---?-------M-B--?--------v
--------------BB---?-B-----?------------------?--------------------M?---?-------
------?B-----M-?--?--------BM-----B---------?------?-------------?--------------
----B------?-----------------?------------------B--------B?---------------B-----
----------B------------B-----B--------M-------B---------?B----------------------
-----------B-------M------------?T--?----?-----B---?----?-----B---------B-TB----
---------------------------T-----|--------T-------------------------------|-----
m--------------------------|-----|--------|-----T--------------T----------|-----
XXXXXXXXXXXXXXXXXXXXXXXXXXX|XXXXX|XXXXXXXX|XXXXX|XXXXXXXXXXXXXX|XX--XXXXXX|XXXXX
