------------------------------------------------------------
------------------------------------------------------------
------------------------------------------------------------
------------------------------------------------------------
------------------------------------------------------------
------------------------------------------------------------
-------MMMMMMMMMMMMMMMMMMMMMMMMMMMMMMMMMMMMMMMMMMM----------
-------MMMMMMMMMMMMMMMMMMMMMMMMMMMMMMMMMMMMMMMMMMM--------v-
-------MMMMMMMMMMMMMMMMMMMMMMMMMMMMMMMMEMMMMMMMMME----------
-------BBBBBBBBBBBBEBBBEBEBBBBBBBBBBBBBBBBBBBBBBBE----------
-------MMMMMMMMMMEMMMMMMMMMMMMEMMMMMMMEMMMMMMMMMMM----------
-------MMMMMMMMMMMMMMMMMMMMMMMMMMMMMMMMMMMMMEMMMMM-EE-------
-------BBBBBBBBBBBBBBBBBBBBBBBBBBBBBBBBBBBBBBBBBB-X?M-------
------------------------------------------------------------
m--------------T---------------T-----------------T----------
XXXXXXXXXXXXXXX|XXXXXXXXXXXXXXX|XXXXXXXXXXXXX--XX|XXXXX--XXX
