------------------------------------------------------------
------------------------------------------------------------
------------------------------------------------------------
------------------------------------------------------------
----------M?X-----MX----X---X---X?------BX-XX--X--X---------
X-E---E-?--M-----X-ME------M----o---?-M---------?XB---------
--?-------B---------o--?-------X---?--XXo-|?----X-----------
-M---?B-o--?------M-B--M------o-BX-X--?--?-X-B-----------v--
oX------M-----------X----o-?---------o-o-----?---B-------f--
--B|-------X--o---X-------XB?---X-B--MX--MX-----o?-------f--
?-------?-M---?M--X-o--------o--X-X----E----------B------f--
-oMX-o---oX---B---?--|X-X-M-X---------X-M---X----B-------f--
B-|?-M------B--M-oX-B?---?-B-X-----o------------o--------f--
---------------------------------------------------------f--
m-------------------------------------------------------XXXX
XXXXXXXXXXXXXXXXXXXXXXXXXXXXXXXXXXXXXXXXXXXXXXXXXXXXXXXXXXXX
