--------------------------------------------------------------------------------
--------------------------------------------------------------------------------
--------------------------------------------------------------------------------
--------------------------------------------------------------------------------
--------------------------------------------------------------------------------
--------------------------------------------------------------------------------
----?-----?------B-----B--------------?----------?------??----B-----------------
----------?-----------?--?-------?B?-----------------------------------?-------v
-----------?-BB-----B--------------?----?---------------------------------B?----
-------------------?-B---B-----BB----?---------------M--------------------------
----?-------------?--------B---------------------B-------?-?--?-B-----B--B-B----
-----M------------------B??-?---??---B-----------BMB-?------------?-------------
--------BB--------?--?------------------B-B------------B-----?-?-B----B---B-----
--------------------------------------------------------------------------------
m----------------------------------------------T--------------------------------
XXXXXXXXXXXXXXXXXXXXXXXXXXXXXXXXXXXXXX--XXXXXXX--XXXXXXXX--XXXXXXXX--XXXXXXXXXXX
