------------------------------------------------------------
------------------------------------------------------------
------------------------------------------------------------
------------------------------------------------------------
------------------------------------------------------------
------------------------------------------------------------
------------------------------------------------------------
-------B--------E-E------B----B--------o-------E--------v---
-------------o--o-----------------------o----o----------f---
-------ooooooEooEooooooBEooooooooooooooBooooooooooEMB---f---
-------oooooEoEoooEoooEoooEoooooooooooooooooBooooo------f---
-------ooMoooooooooBooooooooooooooooBoooooooEooooB------f---
-------oooooooooooooooooooooooooooooooooooooooooooB-----f---
--------------------------------------------------T-----f---
m------------------------------------------------T|-----X---
XXXXXXXXXXXXXXXXXXXXXXXXXXXXXXXXXXX--XXXXXXXXXXXX||XXXXXXXXX
