------------------------------------------------------------
------------------------------------------------------------
------------------------------------------------------------
------------------------------------------------------------
------------------------------------------------------------
------------------------------------------------------------
-------BBBBBBBBBBBBBBBBBBBBBBBBBBBBBBBBBBBBBBBBBBB----------
-------BBBBBBBBBBBBBBBBBBBBBBBBBBBBBBBBBBBBBBBBBBBo-E-----v-
-------BBBBBBBBBBBBBBBBBBBBBBBBBBBBBBBBEBBBBBBBBBEX??-------
-------BBBBBBBBBBBBEBBBEBEBBBBBBBBBBBBBBBBBBBBBBBE----------
-------MMMMMMMMMMEMMMMMMMMMMMMEMMMMMMMEMMMMMMMMMMM----------
-------BBBBBBBBBBBBBBBBBBBBBBBBBBBBBBBBBBBBBBBBBBB----------
-------BBBBBBBBBBBBBBBBBBBBBBBBBBBBBBBBBBBBBBBBBBoBBB-------
-------------------------------------------------------T----
m--------------T---------------T-----------------T-----|----
XXXXXXXXXXXXXXX|XXXXXXXXXXXXXXX|XXXXXXXXXXXXX--XX|XXXXX|XXXX
