------------------------------------------------------------
------------------------------------------------------------
------------------------------------------------------------
------------------------------------------------------------
------------------------------------------------------------
------------------------------------------------------------
-------MMMMMMMMMMMMMMMMMMMMMMMMMMMMMMMMMMMMMMMMMMM----------
-------MMMMMMMMMMMMMMMMMMMMMMMMMMMMMMMMMMMMMMMMMMM--------v-
-------MMMMMMMMMMMMMMMMMMMMMMMMMMMMMMMMEMMMMMMMMME----------
-------MMMMMMMMMMMMMMMMMMMMMEMMMMMMMMMMMMMMMMMMMEE----------
-------MMMMMMMMMMMMMMMMMMMMMMMMMMMMMMMMMMMMMEMMMMMXM--------
-------MMMMMMMMMMMMMMMMMMMMMMMMMMMMMMMMMMMMMMMMMMM----------
-------MMMMMMMMMMMMMMMMMMMMMMMMMMMMMMMMMMMMMMMMMMB----------
-------------------------------------------------------T----
m---------T-------T----------------------------T-------|----
XXXXXXXXXX|XXXXXXX|XXXXXXXXXXXX--XXXXXXXX--XXXX|XXXXXXX|XXXX
