------------------------------------------------------------
------------------------------------------------------------
------------------------------------------------------------
------------------------------------------------------------
------------------------------------------------------------
------------------------------------------------------------
--o---------------------------------------------------------
-----------------------------------------------------------v
-----------------------------------------------------------f
-----------------------------------------------------------f
-----------------------------------------------------------f
-----------------------------------------------------------f
-----------------------------------------------------------f
-----------------------------------------------------------f
m-E------------------------------------------B-------------X
XXXXXXXXXXXXXXXXXXXXXXXXXXXXXXXXXXXXXXXXXXXXXXXXXXXXXXXXX-XX
