--------------------------------------------------------------------------------
--------------------------------------------------------------------------------
--------------------------------------------------------------------------------
--------------------------------------------------------------------------------
--------------------------------------------------------------------------------
--------------------------------------------------------------------------------
----B?---B-------?---------M-------M------B------?--------?---B-M----?--?-------
-----------?-------------M?-B--------------B?--B--B-----B----------------------v
----------M?-------M-----B?--?---------------?-M?----B?-------------------------
----------B-------BB--?------------?-------B------------------------------------
-----------?--M-------------------B----B-?---B----?---B---------B--------?------
------?---B----?-B-------?--------B-B--------------------B-?--------------------
----?-?---??---------------B--------?-?--------B-----B---T--------B-B---T---?---
---------------------------------------------------------|--------T-----|-------
m--------------------------------------------------------|--------|-----|-------
XXXXXXXXXXXXXXXXXXXXXXXXXXXXXXXXXX--XXXXXXXXXXXXXXXXXXXXX|X--XXXXX|XXXXX|XXXXXXX
