------------------------------------------------------------
------------------------------------------------------------
------------------------------------------------------------
------------------------------------------------------------
------------------------------------------------------------
------------------------------------------------------------
------------------------------------------------------------
--------o------E---o--------------------------------------v-
-------------?-E--------E----------------M--------E---------
--------------------------------E------------o----EE--------
----------B?---------------------?----?----?-----BEEo-------
---------E--------M-M-----------------M--?-E------E---------
---------------------??---M-----------------B-----XXM-------
-------------------------------------------------------T----
m------------------------------------------------------|----
XXXXXXXXXXXXXXXXXXXXXXXXXXXXXXXXXXXXXXXXXXXXXXXXXX-XXXX|XXXX
