-------------------------------------------?------?---------
-------B--------------------------M-------------------------
------------------------------------------------------------
-------?----------------------------------------------T-M---
-------------------X----------------------------------|-----
------------------XX---------------------------------X|---X-
-----------------XXX--------------------------------XX|-----
---M------------XXXX-------------------------------TXX|----v
---------------XXXXX------------------------------X|XX|----f
--M-----------XXXXXX-----------------------------XX|XX|----f
--------X-T--XXXXXXX----------------------------XXX|XX|----f
--------XX|-XXXXXXXX---------------------------XXXX|XX|----f
----o---XX|XXXXXXXXX-----X--------------------XXXXX|XX|----f
--?-----XX|XXXXXXXXX-------------------------XXXXXX|XX|----f
m-X-E---XX|XXXXXXXXX-------------E----------XXXXXXX|XX|----X
XXXXXXX-XX|XXXXXXXXXXXXXXXXXXX--XXXXXXXXXXXXXXXXXXX|XX|XXXXX
