--------------------------------------------------------------------------------
--------------------------------------------------------------------------------
--------------------------------------------------------------------------------
--------------------------------------------------------------------------------
--------------------------------------------------------------------------------
--------------------------------------------------------------------------------
-----------------------?----------BB---BB---?--B-----?----?--------?-------?----
-----?---------B-----?--------BB-----B---------------B----?-------B------------v
----?-------?-----------------------------?--------M----B-------B---------------
-----?------?-----------?-----?-------B-------B---?---------------?---B----B----
-------?---B---------------??---?----?------------------------------------------
----------------B-------------?--------------?------M---------B-----------------
----------------------?------?--M--------?--BT-------B-------?------?T----------
---------------------------------------------|----------T------------|----------
m--------------------------------------------|----------|------------|----------
XXXXXXXXXXXXXXXXXXXXXXXXXXXXXXXXXXXXXX--XXXXX|XXXX--XXXX|XXXXXXXX--XX|XXXXX--XXX
