------------------------------------------------------------
------------------------------------------------------------
------------------------------------------------------------
------------------------------------------------------------
------------------------------------------------------------
------------------------------------------------------------
--X-XX----XX--X------X---------X-X-X-----X---X-X---B--------
-------X------X------X-------XBX-----X-----X----X--X-----XXv
---X?-------X-------XX------X----------X-----XX----XX-------
X--------B-----------------X----X-X----------X-----BX-X-----
-BX---X--------X-----B-----X-X----------X-----------X---X---
X-X----B-B---------B--------------XXX--B---------X------X-X-
X-------X----X-X---XX-X----X-B--B-X----?------------X-------
------------------------------------------------------------
m--------------------------------T--------------------T-----
XXXXXXXXXXXXXXXXXXXXXXXX--XXXXXXX|XXXXXXXXXXXXXXXXXXXX|XXXXX
